#Section 1
0		o	0	
1		yek	ye	1
2		do	doo	too	2
3		se	se'	3	
4		chahar	char	cha	for	4
@		at	@
30		si	si'	30
ok		ok	okey	#start
cd		si'di	cd	#start
copy		kopy	copy	#start
address		aadres	address	#start
power		paawer	power	#start
bye		baay	bye	#wholeword
computer		kaampiyoter	computer	#start
idea		ideh	idea	#start
project		projeh	project	#start
site		sayt	site	#start
free		aazaad	firi	free	#start
email		imeil	email	#start
mail		meil	imeil	mail	#start
technical		teknikal	fanni	technical	#start
page		safhe	peyj	page	#start
ip		aay'pi	ip	#start
type		taayp	type	#start
change		cheng	taqyeer	change	#start
check		chek	check	#start
star		estaar	setareh	star	#start
dialup		dayal'aap	dialup	#start
research		tahqiq	reserch	research	#start
tv		telvizion	ti'vi	tv	#start
good		good	khoob	#start
persian		pershyan	farsi	persian	#start
tool		tool	abzar	#start
toefl		taafel	toefl	#start
memory		memory	hafeze	#start
RAM		RAM	hafeze	#start
CPU		si'pi'yoo	CPU	#start
title		taaytel	onvan	title	#start
contact		kaantakt	contact	#start
dg		dige	dg	#wholeword
january		jaanvye	january	#wholeword
february		fevrye	february	#wholeword
march		maars	march	#wholeword
april		aavril	april	#wholeword
may		meh	may	#wholeword
june		jooan	june	#wholeword
july		joolay	july	#wholeword
august		aagost	august	#wholeword
september	septaambr	september	#wholeword
october		oktobr	october	#wholeword
november		novaambr	november	#wholeword
december		desaambr	december	#wholeword
sms	es'em'es	payamak	sms	#start
ADSL	ey'di'es'el	ADSL	#start
facebook	feysbook	facebook	#start
music	moozik	music	#start
weblog	weblag	weblog	#start
download	danlod	download	#start
online	aanlayn	online	#start
bug	baag	bug	#wholeword
ine	ine	ayne	ayn	#end
ile	ile	ayle	ayl	#end
plz	lotfan	pleez	plz	#wholeword
save	seyv	save	#start
down	daan	#start
khish	khish	khvish
resume	rezumeh	#start
data	data	deyta	#start
end	end	akhar	#start
version	version	verjen	#start
feature	feature	vijegi	#start
http	http	ech'ti'ti'pi	#start
html	html	ech'ti'em'el	#start

#Section 2
1bar	یکبار	#exact
2gholooyim	دوقلویم	#exact
2ke	توکه	#exact
2khtare	دوختر	#exact
2nbalesh	دونبالش	#exact
2nya	دنیا	#exact
2nyaye	دونیای	2نیای	#exact
2roo	دورو	#exact
2rost	درست	#exact
2roste	دورسته	دورست	#exact
2shab	توشب	دوشب	2شب	#exact
2vom	دوم	#exact
2zari	دوزاری	#exact
3ta	سه‌تا	3تا	#exact
3vome	سومه	#exact
3vomi	سومی	#exact
4omi	چهارمی	#exact
4omish	چهارمیش	#exact
4shanbeh	چهارشنبه	#exact
aah	آه	آاه	#exact
aalan	آلان	#exact
aale	آل	آله	#exact
aarezoo	آرزو	#exact
aashegh	عاشق	#exact
aashnaayi	آشنایی	#exact
aavordam	آوردم	#exact
ab	آب	#exact
abad	ابد	آباد	#exact
abam	آبم	#exact
abas	عباس	#exact
abaye	عبای	ابای	#exact
abb	آب	#exact
abbas	عباس	#exact
abbase	عباس	#exact
abd	عبد	#exact
abe	آب	آبه	#exact
abere	عابر	#exact
aberoosh	آبروش	#exact
abesh	آبش	#exact
ablah	ابله	#exact
about	اباوت	درباره‌ی	about	#exact
abr	ابر	#exact
abre	ابر	#exact
absolute	ابسلوت	آبسلوته	مطلق	absolute	#exact
abstract	آبسترکت	خلاصه	abstract	#exact
adab	ادب	آداب	#exact
adabiate	ادبیات	#exact
adam	آدم	عدم	#exact
adama	آدما	#exact
adamae	آدمایی	#exact
adamaye	آدمای	#exact
adame	آدم	آدمه	#exact
adami	آدمی	عدمی	#exact
adamim	آدمیم	#exact
add	ادد	عاد	اضافه	add	#exact
add	اد	اضافه	add	#exact
addam	آدم	ادم	#exact
addi	عادی	#exact
addres	آدرس	address	#exact
address	آدرس	address	#exact
addresse	آدرس	address	#exact
adress	آدرس	address	#exact
adsl	ای.دی.اس.ال	adsl	#exact
aee	آی	ای	#exact
afarin	آفرین	#exact
afaryn	آفرین	#exact
afrazemun	افرازمون	#exact
afsordaro	افسردرو	#exact
afsorde	افسرده	#exact
afsordegi	افسردگی	#exact
afzari	افزاری	#exact
afzoun	افزون	#exact
agar	اگر	#exact
agarche	اگرچه	#exact
age	اگه	#exact
ageh	اگه	#exact
agha	آقا	#exact
aghab	عقب	#exact
aghaee	اقأیی	#exact
aghal	اقل	#exact
aghay	آقای	#exact
aghaye	آقای	#exact
aghayi	آقایی	#exact
aghayun	آقایون	#exact
ahali	اهالی	#exact
ahamiat	اهمیت	#exact
ahamiate	اهمیت	#exact
ahamyate	اهمیت	#exact
ahan	آهان	#exact
ahanag	آهنگ	#exact
ahanagha	آهنگ‌ها	#exact
ahang	آهنگ	#exact
ahange	آهنگ	آهنگه	#exact
ahangesho	آهنگشو	#exact
ahanghai	آهنگ‌هایی	#exact
ahanghaye	آهنگهای	#exact
ahangi	آهنگی	#exact
ahangiro	آهنگیرو	اهنگیرو	#exact
ahango	آهنگو	#exact
ahh	آه	اه	#exact
ahmad	احمد	#exact
ahmaghane	احمقانه	#exact
ahmaghe	احمق	#exact
ahoo	آهو	#exact
ahvale	احوال	#exact
ajab	عجب	#exact
ajale	عجله	#exact
ajib	عجیب	#exact
ajibe	عجیبه	#exact
ajnas	اجناس	#exact
akase	عکاس	#exact
akhar	آخر	#exact
akharam	آخرم	#exact
akhare	آخر	#exact
akharesh	آخرش	#exact
akharesham	آخرشم	#exact
akharesho	آخرشو	#exact
akharim	آخریم	#exact
akhe	آخه	#exact
akhlaghii	اخلاقی	#exact
akhmato	اخماتو	#exact
aks	عکس	#exact
aksare	اکثر	#exact
akse	عکس	#exact
aksio	عکسیو	#exact
akso	عکسو	#exact
akso	عکس‌و	#exact
alaagheye	علاقه‌ی	علاقه	#exact
alaan	الآن	الان	#exact
alagham	علاقم	#exact
alaghamo	علاقمو	#exact
alaghat	علاقت	#exact
alaghemand	علاقمند	#exact
alagheye	علاقه‌ی	#exact
alaki	الکی	#exact
alam	عالم	#exact
alamat	علامت	#exact
alame	عالمه	علامه	#exact
alan	الان	#exact
alanam	الآنم	آلنم	#exact
alave	علاوه	#exact
alaveye	علاوه‌ی	علاوه	#exact
albat	البت	#exact
albate	البته	#exact
albateh	البته	#exact
albatte	البته	#exact
album	آلبوم	#exact
albuma	آلبوما	#exact
albumam	آلبومم	#exact
albumasho	آلبومشو	البومشو	#exact
aleykom	علیکم	#exact
aleykomo	علیکم‌و	علیکم	#exact
ali	علی	عالی	#exact
alireza	علیرضا	#exact
alkolo	آلکلو	#exact
all	آل	#exact
allarhaie	تلارهایی	#exact
alli	علی	عالی	#exact
alo	الو	#exact
am	ام	#exact
ama	اما	#exact
amaa	اما	#exact
amad	آمد	#exact
amade	آماده	آمده	#exact
amadegie	آمادگی	#exact
amadeh	آماده	آمده	#exact
amal	عمل	#exact
amalkarde	عملکرد	#exact
aman	امان	#exact
amar	آمار	#exact
amare	آمار	#exact
amari	آماری	#exact
ame	عمه	عام	#exact
ameye	عامه‌ی	عمه‌ی	#exact
amin	امین	آمین	#exact
amir	امیر	#exact
amma	اما	#exact
ammaa	اما	#exact
ammamo	عممو	#exact
amme	عمه	عامه	#exact
amped	آمپد	امپد	#exact
amr	امر	#exact
amrica	آمریکا	#exact
amricaii	آمریکایی	#exact
amricaiia	آمریکاییا	#exact
amricaiiha	آمریکاییها	#exact
amricaiim	آمریکاییم	#exact
amricayiya	آمریکییا	#exact
amrika	آمریکا	#exact
an	ان	آن	#exact
anahita	آناهیتا	#exact
anar	انار	#exact
and	اند	و	#exact
andakhtaman	اندختمن	#exact
andaze	اندازه	#exact
andazeh	اندازه	#exact
andazeie	اندازه‌ی	اندازه	#exact
andookhte	اندوخته	#exact
angooro	انگورو	#exact
anjaam	انجام	#exact
anjam	انجام	#exact
apartment	آپرتمنت	آپارتمان	apartment	#exact
aqa	آقا	#exact
arab	عرب	#exact
arabemoon	عربمون	#exact
arabi	عربی	#exact
aramesh	آرامش	#exact
architecture	آرکیتکچر	معماری	architecture	#exact
are	آره	#exact
areh	آره	#exact
arezo	آرزو	#exact
arezoi	آرزوی	آرزویی	#exact
arezoo	آرزو	#exact
arezoo	آرزو	#exact
arezoohatono	آرزوهاتو	#exact
arezoom	آرزوم	#exact
arezooye	آرزوی	#exact
arezooye	آرزوی	#exact
aria	آریا	#exact
armin	آرمین	#exact
aroom	آروم	#exact
aroomam	آرومم	#exact
aroosi	عروسی	#exact
aroosish	عروسیش	#exact
aroosisho	عروسیشو	#exact
arosi	عروسی	#exact
arosie	عروسی	#exact
arosish	عروسیش	#exact
arrangement	ارنجمنت	آرایش	arrangement	#exact
arteshe	ارتش	#exact
arusi	عروسی	#exact
arusie	عروسی	#exact
arusy	عروسی	#exact
arz	عرض	#exact
arzesh	ارزش	#exact
arzeshe	ارزش	#exact
as	از	مثل	as	#exact
asaabe	اعصاب	#exact
asaabo	اعصابو	#exact
asabamo	اعصابمو	#exact
asabaniyat	عصبانیت	#exact
asabe	اعصاب	#exact
asan	آسان	#exact
asari	اثری	آثاری	#exact
asemoon	آسمون	#exact
asgari	عسگری	#exact
ashegh	عاشق	#exact
ashegh	عاشق	#exact
asheghe	عاشق	#exact
asheghe	عاشق	#exact
asheghesh	عاشقش	#exact
ashk	اشک	#exact
ashke	اشک	#exact
ashna	آشنا	#exact
ashnaa	آشنا	#exact
ashpaz	آشپز	#exact
ashrafi	اشرافی	اشرفی	#exact
asl	ای.اس.ال	مشخصات لطفا	ASL	#exact
aslahe	اسلحه	#exact
aslan	اصلا	#exact
aslanam	اصلنم	اصلانم	#exact
asle	اصل	#exact
asly	اصلی	#exact
asr	عصر	#exact
asresh	عصرش	اثرش	#exact
asri	عصری	اثری	#exact
assalam	عسلم	#exact
assalamo	عسلمو	#exact
assar	اثر	عصار	#exact
ast	است	#exact
astin	آستین	#exact
at	ات	#exact
atiyeo	آتیه‌و	آتیه	#exact
australia	استرالیا	#exact
avaghebe	عواقب	#exact
avakher	اواخر	#exact
aval	اول	#exact
avalan	اولا	#exact
avalesh	اولش	#exact
avalet	اولت	#exact
avalieye	اولیه‌ی	اولیه	#exact
avalin	اولین	#exact
avalinam	اولینم	#exact
avalish	اولیش	#exact
avatar	آواتار	avatar	#exact
avaz	عوض	#exact
avazi	عوضی	#exact
avordam	آوردم	#exact
avordamo	آوردمو	اوردمو	#exact
avordan	آوردن	#exact
avorde	آورده	آورد	#exact
avva	آوا	#exact
avval	اول	#exact
avvalin	اولین	#exact
ax	عکس	#exact
axa	عکسا	#exact
axatam	اکساتم	#exact
axe	عکس	آخه	#exact
axesho	عکسشو	#exact
axolamale	عکس‌العمل	#exact
ay	آی	ای	#exact
aya	آیا	#exact
ayad	آید	#exact
ayandash	آیندش	#exact
ayande	آینده	#exact
aye	ای	آیه	#exact
ayne	آینه	عین	#exact
az	از	آز	#exact
aza	عزا	#exact
azad	آزاد	#exact
azadari	عزاداری	#exact
azado	آزادو	#exact
azam	ازم	اعظم	#exact
azari	آزاری	آذری	#exact
azash	ازش	#exact
azashoon	ازشون	#exact
azat	ازت	#exact
azaye	اعضای	عزاعی	#exact
azemat	عظمت	#exact
aziyat	اذیت	#exact
aziz	عزیز	#exact
azizam	عزیزم	#exact
aziztarin	عزیزترین	#exact
azmayeshi	آزمایشی	#exact
azun	ازون	#exact
ba	با	#exact
ba'de	بعد	باد	#exact
baa	با	#exact
baad	بعد	باد	#exact
baadan	بعدا	#exact
baadesh	بعدش	#exact
baahaatoon	باهاتون	#exact
baalaaye	بالای	بالایه	#exact
baar	بار	#exact
baasham	باشم	#exact
baashe	باشه	#exact
baaz	باز	#exact
baazam	بازم	#exact
baaziao	بازی‌و	بازی	#exact
baba	بابا	#exact
babai	بابایی	#exact
babam	بابام	#exact
babash	باباش	#exact
babate	بابت	#exact
babaye	بابای	#exact
bache	بچه	#exact
bachegiamooneha	بچگیامونه‌ها	#exact
bachegoone	بچه‌گونه	بچگونه	#exact
bacheha	بچه‌ها	#exact
back	بک	قبل	back	#exact
bad	بعد	بد	باد	#exact
badak	بدک	#exact
badam	بدم	بادام	#exact
badan	بدن	بعداً	#exact
badanamo	بدنمو	#exact
badbakhte	بدبخت	#exact
badbakhtit	بدبختیت	#exact
bade	باد	بده	بد	#exact
badesh	بعدش	بدش	بادش	#exact
badesham	بعدشم	بدشم	#exact
badesham	بعدشم	#exact
badet	بدت	#exact
badi	بعدی	بدی	#exact
badid	بدید	#exact
badit	بدیت	بعدیت	#exact
badtar	بدتر	#exact
baed	بعد	بعید	#exact
baede	بعیده	بعد	#exact
baftam	بافتم	#exact
baghal	بغل	بقال	#exact
baghalete	بغلته	بغلت	#exact
baghi	باقی	#exact
baghiasham	بقیشم	#exact
baghie	بقیه	#exact
baghieye	بقیه‌ی	بقیه	#exact
baghiyeye	بقیه‌ی	بقیه	#exact
bah	به	باه	#exact
bahal	باحال	#exact
bahalan	باحالن	#exact
bahale	باحاله	#exact
bahali	باحالی	#exact
baham	باهام	باهم	#exact
bahar	بهار	#exact
bahash	باهاش	#exact
bahashon	باهاشون	بهاشون	#exact
bahatoon	باهاتون	بهاتون	#exact
bahoneie	بهونه‌ی	#exact
bahoonan	بهونن	#exact
bahooshid	باهوشید	#exact
baiad	باید	#exact
baian	بیاین	#exact
bakere	باکره	#exact
bakereye	باکره‌ی	باکره	#exact
bakht	بخت	باخت	#exact
bala	بالا	#exact
balad	بلد	#exact
balade	بلد	بلده	#exact
balaha	بالاها	بلاها	#exact
balast	بالاست	#exact
balatar	بالاتر	#exact
balaye	بالای	#exact
balayee	بالایی	بلایی	#exact
bale	بله	بال	باله	#exact
baline	بالین	#exact
ball	بال	#exact
band	بند	باند	#exact
bande	بنده	#exact
bar	بر	بار	#exact
bara	برا	#exact
baraam	برام	#exact
baraaye	برای	#exact
barabar	برابر	#exact
baradaram	برادرم	#exact
baradaramo	برادرمو	#exact
baradaret	برادرت	#exact
barai	برای	#exact
barakatoh	برکاته	#exact
baram	برام	#exact
baramoon	برامون	#exact
barash	براش	#exact
barashoon	براشون	#exact
barat	برات	#exact
baratoon	براتون	#exact
baratun	براتون	#exact
baravarde	برآورده	#exact
baraye	برای	#exact
barazande	برازنده	#exact
bardari	برداری	#exact
bare	باره	بار	#exact
baremoon	برمون	بارمنون	#exact
barf	برف	#exact
bargardoond	برگردوند	#exact
bargashatam	برگشتم	#exact
bargashtam	برگشتم	#exact
bargashtim	برگشتیم	#exact
barghamoon	برقامون	برقمون	#exact
barie	برای	باریه	#exact
barmigardam	برمی‌گردم	برمیگردم	#exact
barmigardim	برمی‌گردیم	برمیگردیم	#exact
barmigardoonam	برمی‌گردونم	برمیگردونم	#exact
barmigashtam	برمی‌گشتم	برمیگشتم	#exact
barmoon	برمون	#exact
barnamast	برنامست	#exact
barname	برنامه	#exact
barnamehaye	برنامه‌های	#exact
barnamei	برنامه‌ای	#exact
baro	برو	بارو	#exact
barobaxe	بروبکس	#exact
baroon	بارون	#exact
bartaraf	برطرف	#exact
bas	بس	#exact
basam	باسم	#exact
bash	باش	#exact
basham	باشم	#exact
bashamesh	باشمش	#exact
bashan	باشن	#exact
bashar	بشر	#exact
bashe	باشه	#exact
basheh	باشه	#exact
bashi	باشی	#exact
bashid	باشید	#exact
bashim	باشیم	#exact
bashin	باشین	#exact
bastare	بستر	#exact
baste	بسته	#exact
bastegi	بستگی	#exact
basti	بستی	#exact
bat	بات	#exact
batman	بتمن	#exact
bavar	باور	#exact
bavaret	باورت	#exact
bavaretoon	باورتون	#exact
bax	بکس	#exact
bayad	باید	#exact
bayd	باید	#exact
baz	باز	#exact
bazam	بازم	#exact
bazarie	بازاری	بازاریه	#exact
bazesh	بازش	#exact
bazgasht	بازگشت	#exact
bazi	بعضی	بازی	#exact
bazia	بعضیا	#exact
bazie	بازی	بازیه	#exact
baziro	بازی‌رو	#exact
bazish	بعضیش	#exact
bazrasi	بازرسی	#exact
be	به	#exact
bebakhshid	ببخشید	#exact
bebakhsid	ببخثید	#exact
bebandim	ببندیم	#exact
bebari	ببری	#exact
bebarid	ببرید	#exact
bebarin	ببرین	#exact
bebin	ببین	#exact
bebinad	ببیند	#exact
bebinam	ببینم	#exact
bebinam	ببینم	#exact
bebinamesh	ببینمش	#exact
bebinamet	ببینمت	#exact
bebinan	ببینن	#exact
bebinid	ببینید	#exact
bebinim	ببینیم	#exact
bebinin	ببینین	#exact
becharkh	بچرخ	#exact
becharkhim	بچرخیم	#exact
bedam	بدم	#exact
bedan	بدن	بدان	#exact
bedd	بد	#exact
bede	بده	#exact
bedi	بدی	#exact
bedid	بدید	#exact
bedim	بدیم	#exact
bedin	بدین	#exact
bedonan	بدونن	#exact
bedone	بدون	#exact
bedoonam	بدونم	#exact
bedoonan	بدونن	#exact
bedoone	بدون	#exact
bedoone	بدون	#exact
bedoonee	بدونه	بدونی	بدون	#exact
bedoune	بدون	#exact
bedozde	بدزده	#exact
bedun	بدون	#exact
bedunim	بدونیم	#exact
bedy	بدی	#exact
befahmam	بفهمم	#exact
befahme	بفهمه	#exact
befahmid	بفهمید	#exact
befarma	بفرما	#exact
befrest	بفرست	#exact
begam	بگم	#exact
began	بگن	#exact
bege	بگه	#exact
begi	بگی	#exact
begid	بگید	#exact
begim	بگیم	#exact
begin	بگین	#exact
begir	بگیر	#exact
begiram	بگیرم	#exact
begiran	بگیرن	#exact
begiri	بگیری	#exact
begirin	بگیرین	#exact
bego	بگو	#exact
bego	بگو	#exact
begoo	بگو	#exact
begu	بگو	#exact
begyr	بگیر	#exact
begzaaram	بگذارم	#exact
begzaaramesh	بگزارمش	بگذارمش	#exact
begzaarand	بگذارند	#exact
begzaram	بگذارم	بگذرم	#exact
begzare	بگذره	#exact
begzari	بگذاری	#exact
behdasht	بهداشت	#exact
behem	بهم	#exact
behesh	بهش	#exact
behesho	بهشو	#exact
behesht	بهشت	#exact
behet	بهت	#exact
behetoon	بهتون	#exact
behnam	بهنام	#exact
behshahr	بهشهر	#exact
behtar	بهتر	#exact
behtaran	بهترن	#exact
behtare	بهتره	#exact
behtaresham	بهترشم	#exact
behtarie	بهتریه	بهتری	#exact
behtarin	بهترین	#exact
behtarine	بهترین	بهترینه	#exact
behtarinha	بهترین‌ها	#exact
behzad	بهزاد	#exact
beinetun	بینتون	#exact
bekar	بکار	#exact
bekarat	بکارت	#exact
bekeshe	بکشه	#exact
bekhab	بخواب	#exact
bekhabam	بخوابم	#exact
bekhad	بخواد	#exact
bekhaid	بخواید	#exact
bekhaie	بخیه	#exact
bekhan	بخوان	#exact
bekhand	بخند	#exact
bekhandam	بخندم	#exact
bekharam	بخرم	#exact
bekharim	بخریم	#exact
bekhater	بخاطر	#exact
bekhatere	بخاطر	بخاطره	#exact
bekhay	بخوای	#exact
bekhodeton	بخودتون	#exact
bekhonin	بخونین	#exact
bekhoninesh	بخونینش	#exact
bekhoon	بخون	#exact
bekhoonam	بخونم	#exact
bekhosos	بخصوص	#exact
bekhounama	بخونما	#exact
bekhunam	بخونم	#exact
bekonam	بکنم	#exact
bekoni	بکنی	#exact
bekonid	بکنید	#exact
bekoobam	بکوبم	#exact
belakhare	بالاخره	#exact
belakhareh	بالاخره	#exact
belgheysam	بلقیسم	#exact
bem	بم	بهم	#exact
bemir	بمیر	#exact
bemiram	بمیرم	#exact
bemoone	بمونه	#exact
benazaram	بنظرم	#exact
bendazam	بندازم	#exact
bendazim	بندازیم	#exact
benevis	بنویس	#exact
benevisam	بنویسم	#exact
benevise	بنویسه	بنویس	#exact
beneviseh	بنویسه	بنویس	#exact
benevisid	بنویسید	#exact
benevisin	بنویسین	#exact
benvisand	بنویسند	#exact
benvisin	بنویسین	#exact
benzino	بنزینو	#exact
bepaiin	بپایین	#exact
bepashi	بپاشی	#exact
bepors	بپرس	#exact
beporsam	بپرسم	#exact
bera	برا	#exact
beram	برم	#exact
beran	برن	بران	#exact
beravad	برود	#exact
bere	بره	#exact
berenj	برنج	#exact
beresam	برسم	#exact
beresan	برسن	#exact
berese	برسه	#exact
beresi	برسی	#exact
beresim	برسیم	#exact
beresoon	برسون	#exact
beresun	برسون	#exact
beresune	برسونه	#exact
beri	بری	#exact
berid	برید	#exact
berim	بریم	#exact
berin	برین	#exact
beriz	بریز	#exact
berizam	بریزم	#exact
besh	بش	#exact
besham	بشم	#exact
beshan	بشن	#exact
beshe	بشه	#exact
beshi	بشی	#exact
beshid	بشید	#exact
beshim	بشیم	#exact
beshinam	بشینم	#exact
beshnasam	بشناسم	#exact
beshnasi	بشناسی	#exact
beshnavam	بشنوم	#exact
beshnavi	بشنوی	#exact
besiar	بسیار	#exact
besiari	بسیاری	#exact
besyar	بسیار	#exact
bet	بت	#exact
beta	بتا	beta	#exact
betalat	بطالت	#exact
beterekoonam	بترکونم	#exact
betonim	بتونیم	#exact
betoonam	بتونم	#exact
betoonan	بتونن	#exact
betooni	بتونی	#exact
betoonim	بتونیم	#exact
beyne	بین	#exact
beza	بزا	#exact
beza'at	بضاعت	بزات	#exact
bezaat	بضاعت	بزات	#exact
bezan	بزن	#exact
bezanam	بزنم	#exact
bezanano	بزننو	#exact
bezane	بزنه	#exact
bezani	بزنی	#exact
bezanid	بزنید	#exact
bezanid	بزنید	#exact
bezanin	بزنین	#exact
bezar	بذار	#exact
bezaran	بذارن	بزارن	#exact
bezare	بذاره	#exact
bezarid	بزارید	#exact
bezarin	بزارین	#exact
bezoodi	بزودی	#exact
bi	بی	#exact
bia	بیا	#exact
biad	بیاد	#exact
biain	بیاین	بیایین	#exact
biam	بیام	#exact
biaramesho	بیارمش‌و	بیارمش	#exact
biaran	بیارن	#exact
biaranet	بیارنت	#exact
biare	بیاره	#exact
biarineshoon	بیارینشون	#exact
bibi	بیبی	#exact
bichare	بیچاره	بی‌چاره	#exact
bidaresh	بیدارش	#exact
bifaydan	بیفیدن	#exact
bifekret	بیفکرت	#exact
bighami	بی‌غمی	#exact
bikhial	بی‌خیال	بیخیال	#exact
bikhiale	بیخیال	#exact
bikhiali	بی‌خیالی	#exact
bikhiyalesh	بیخیالش	#exact
bikhod	بی‌خود	بیخود	#exact
bimarefati	بی‌معرفتی	#exact
binahaayat	بی‌نهایت	بینهایت	#exact
binamoos	بیناموس	#exact
bingo	بینگو	bingo	#exact
biofte	بیفته	#exact
birah	بیراه	#exact
biroon	بیرون	#exact
biroon	بیرون	#exact
bishtar	بیشتر	#exact
bishtare	بیشتر	#exact
bishtari	بیشتری	#exact
biyad	بیاد	#exact
biyain	بیایین	بیاین	#exact
biyam	بیام	#exact
biyayd	بیاید	#exact
biyaym	بیایم	#exact
biyofte	بیفته	#exact
bkhabio	بیخوابی‌و	#exact
bkhiale	بیخیال	#exact
blackberry	بلکبری	blackberry	#exact
blast	بلست	#exact
blastam	بلستم	بلاستم	#exact
blastayi	بلستایی	#exact
blastet	بلستت	#exact
block	بلوک	block	#exact
blog	بلاگ	#exact
blogamo	بلاگمو	#exact
blogger	بلاگر	#exact
blogspot	بلاگ‌اسپات	#exact
bo'di	بعدی	#exact
bod	بود	#exact
bodam	بودم	#exact
bodaro	بودارو	#exact
boghz	بغض	#exact
boghzam	بغضم	بغضام	#exact
bokhoran	بخورن	#exact
bokhorim	بخوریم	#exact
bokon	بکن	#exact
bokonam	بکنم	#exact
bokone	بکنه	#exact
bokonim	بکنیم	#exact
boland	بلند	#exact
bood	بود	#exact
bood	بود	#exact
bood	بود	#exact
boodam	بودم	#exact
boodan	بودن	#exact
boodanam	بودنم	#exact
boode	بوده	#exact
boodeh	بوده	#exact
boodeha	بوده‌ها	بودها	#exact
boodi	بودی	#exact
boodim	بودیم	#exact
boombool	بومبول	#exact
boose	بوسه	#exact
bordam	بردم	#exact
bordan	بردن	#exact
bordanemoon	بردنمون	#exact
boro	برو	#exact
boss	بوس	#exact
boud	بود	#exact
boudam	بودم	#exact
bozorg	بزرگ	#exact
bozorge	بزرگ	بزرگه	#exact
bozorgi	بزرگی	#exact
brazil	برزیل	#exact
bronze	برنز	برنزه	#exact
browse	بروز	جست‌وجو	browse	#exact
bud	بود	#exact
budam	بودم	#exact
budi	بودی	#exact
bug	باگ	خطا	bug	#exact
but	بات	بوت	ولی	but	#exact
by	بای	خدا‌حافظ	by	#exact
bye	بای	خداحافظ	bye	#exact
c	سی	#exact
cake	کیک	#exact
calculator	کلکولیتر	ماشین حساب	calculator	#exact
campiuteram	کامپیوترم	#exact
can	کن	کان	#exact
canada	کانادا	#exact
cancelie	کنسلیه	#exact
canvas	کانواس	canvas	#exact
card	کارد	کارت	card	#exact
carte	کارت	#exact
cd	سی‌دی	CD	#exact
celaso	کلاس‌و	#exact
cent	سنت	cent	#exact
cera	سرا	#exact
chaee	چایی	#exact
chaker	چاکر	#exact
chakeram	چاکرم	#exact
chakere	چاکر	#exact
chakeretam	چاکرتم	#exact
chakerim	چاکریم	#exact
chand	چند	#exact
chandin	چندین	#exact
change	چنج	تغییر	change	#exact
chap	چپ	چاپ	#exact
character	کرکتر	#exact
charei	چاره‌ای	#exact
chareye	چاره‌ی	#exact
charta	چارتا	#exact
chasb	چسب	#exact
chasbid	چسبید	#exact
chashm	چشم	#exact
chat	چت	#exact
che	چه	#exact
cheghaadr	چقدر	#exact
cheghad	چقد	چقدر	#exact
cheghad	چقد	#exact
cheghadr	چقدر	#exact
chehre	چهره	#exact
chejoori	چجوری	چه‌جوری	#exact
chejori	چه‌جوری	چجوریی	#exact
chekaras	چکارس	#exact
chekhabra	چه‌خبرا	#exact
chepoond	چپوند	#exact
cheqadr	چقدر	#exact
chera	چرا	#exact
cheraa	چرا	#exact
cherto	چرتو	#exact
chesham	چشام	#exact
cheshe	چشه	#exact
cheshm	چشم	#exact
cheshmaki	چشمکی	#exact
cheshmam	چشمام	چشمم	#exact
cheshmash	چشماش	چشمش	#exact
cheshmaye	چشمای	#exact
cheshme	چشمه	چشم	#exact
cheshmet	چشمت	#exact
chetori	چطوری	#exact
chetory	چطوری	#exact
chi	چی	#exact
chie	چیه	#exact
chii	چی	#exact
chikar	چیکار	#exact
chikara	چیکارا	#exact
chin	چین	#exact
chireh	چیره	#exact
chist	چیست	#exact
chiye	چیه	چی	#exact
chiz	چیز	#exact
chiza	چیزا	#exact
chizaii	چیزایی	#exact
chizaye	چیزایی	چیزای	#exact
chizayee	چیزایی	چیزیه	#exact
chize	چیز	#exact
chizesh	چیزش	#exact
chizi	چیزی	#exact
chizie	چیزیه	چیزی	#exact
chiziee	چیزیه	چیزیی	#exact
chiziyam	چیزیم	#exact
chizo	چیزو	#exact
chon	چون	#exact
choon	چون	#exact
chort	چرت	#exact
chossbaghali	چس‌باقلی	#exact
christmas	کریسمس	christmas	#exact
cilick	کیلیک	#exact
cinema	سینما	#exact
cinemast	سینماست	#exact
cinemaye	سینمای	#exact
class	کلاس	#exact
click	کلیک	ضربه‌زدن	click	#exact
clipasho	کلیپشو	#exact
cloud	کلود	#exact
club	کلاب	کلوپ	club	#exact
cluster	کلاستر	cluster	#exact
clustering	کلاسترینگ	#exact
cm	سانتیمتر	cm	سی.ام	#exact
codesh	کدش	#exact
com	کام	#exact
combine	کمباین	#exact
comedy	کمدی	comedy	#exact
comment	کامنت	نظر	comment	#exact
commentet	کامنتت	#exact
comments	کامنتس	#exact
community	کامیونیتی	انجمن	community	#exact
comp	کامپ	#exact
computer	کامپیوتر	computer	#exact
computing	کمپوتینگ	محاسبه	computing	#exact
conect	کانکت	وصل	connect	#exact
conserv	کنسرو	#exact
contact	کنتاکت	کانتکت	ارتباط	contact	#exact
control	کنترل	#exact
copy	کپی	نمونه ساختن	copy	#exact
copyright	کپی‌رایت	copyright	#exact
crak	کرک	crack	#exact
credit	کردیت	credit	#exact
da'em	دائم	#exact
daadam	دادم	#exact
daadan	دادن	#exact
daareh	داره	#exact
daash	داش	#exact
daashtam	داشتم	#exact
daashtand	داشتند	#exact
daashte	داشته	داشت	#exact
dabirestan	دبیرستان	#exact
dad	داد	#exact
dada	دادا	#exact
dadam	دادم	#exact
dadan	دادن	#exact
dadash	داداش	#exact
dadasham	داداشم	#exact
dade	داده	#exact
dadeh	داده	#exact
dadim	دادیم	#exact
dado	دادو	داد	#exact
dadsetan	دادستان	#exact
dafe	دفعه	دفه	دافعه	#exact
dafeye	دفه‌ی	دفعه‌ی	#exact
daghighan	دقیقا	#exact
dahanam	دهانم	#exact
dalil	دلیل	#exact
dalilesh	دلیلش	#exact
dam	دم	دام	#exact
damagh	دماغ	#exact
damaghesho	دماغشو	#exact
dame	دم	#exact
daneshgah	دانشگاه	#exact
daneshgah	دانشگاه	#exact
daneshgahe	دانشگاه	#exact
daneshgatun	دانشگاتون	#exact
dar	در	دار	#exact
darad	دارد	#exact
daram	دارم	#exact
daram	دارم	#exact
daran	دارن	#exact
darare	دراره	#exact
darbiad	دربیاد	#exact
dard	درد	#exact
dardnake	دردناکه	دردناک	#exact
dare	داره	دره	#exact
dareh	داره	#exact
daresho	درشو	#exact
dari	داری	#exact
darid	دارید	#exact
darim	داریم	#exact
darima	داریما	#exact
darin	دارین	#exact
dark	درک	#exact
darke	درک	درکه	#exact
darmaane	درمان	#exact
daroonie	درونی	درونیه	#exact
darooye	داروی	#exact
darovorde	درآورده	#exact
dars	درس	#exact
darsa	درسا	#exact
darush	داروش	داریوش	#exact
dary	داری	#exact
daryaft	دریافت	#exact
daryoosho	داریوش‌و	داریوش	#exact
das	دس	#exact
dasband	دسبند	#exact
daset	دست	#exact
dasgir	دسگیر	#exact
dash	داش	#exact
dash	داش	#exact
dasht	داشت	#exact
dashtam	داشتم	#exact
dashtan	داشتن	#exact
dashte	داشته	#exact
dashteh	داشته	#exact
dashti	داشتی	دشتی	#exact
dashtid	داشتید	#exact
dashtim	داشتیم	#exact
dashtim	داشتیم	#exact
dast	دست	#exact
dastan	داستان	#exact
dastane	داستان	#exact
dastashoono	دستاشونو	#exact
daste	دست	دسته	#exact
dasteh	دسته	#exact
dastesh	دستش	#exact
dasteshoon	دستشون	#exact
dastet	دستت	#exact
dasteton	دستتون	#exact
dastmal	دستمال	#exact
dastshooii	دستشویی	#exact
dastshooye	دستشویی	دستشوی	#exact
dava	دوا	دعوا	#exact
davash	دواش	دعواش	#exact
davat	دعوت	#exact
davate	دعوت	#exact
december	دسامبر	#exact
deghat	دقت	#exact
del	دل	#exact
delam	دلم	#exact
delam	دلم	#exact
dele	دله	دل	#exact
delemoon	دلمون	#exact
delet	دلت	#exact
deletoon	دلتون	#exact
delhaaye	دلهای	#exact
dell	دل	dell	#exact
demoye	دموی	#exact
deqqat	دقت	#exact
dg	دیگه	#exact
dge	دیگه	#exact
dialup	دایالاپ	شماره‌گیری	dial up	#exact
diari	دیاری	#exact
did	دید	#exact
did	دید	#exact
didam	دیدم	#exact
didamesh	دیدمش	#exact
didane	دیدن	دیدنه	#exact
dide	دیده	دید	#exact
didi	دیدی	#exact
didim	دیدیم	#exact
didish	دیدیش	#exact
dig	دیگ	#exact
digam	دیگم	#exact
digar	دیگر	#exact
digaran	دیگران	#exact
digaresh	دیگرش	#exact
digari	دیگری	#exact
digaro	دیگرو	#exact
dige	دیگه	#exact
digeh	دیگه	#exact
dir	دیر	#exact
dirooz	دیروز	#exact
diroz	دیروز	#exact
dishab	دیشب	#exact
dishab	دیشب	#exact
dishabe	دیشب	#exact
disham	دیشم	#exact
distraction	دیسترکشن	حواس‌پرتی	distraction	#exact
distributed	دیستریبوتد	توزیع شده	distrubuted	#exact
divaar	دیوار	#exact
divar	دیوار	#exact
divoonash	دیوونش	#exact
divooneh	دیوونه	#exact
do	دو	#exact
doa	دعا	#exact
dobaare	دوباره	#exact
dobaareh	دوباره	#exact
dobare	دوباره	#exact
dobare	دوباره	#exact
dochar	دچار	#exact
dochare	دچار	#exact
doctor	دکتر	#exact
dodar	دودر	#exact
dodare	دودره	دودر	#exact
doiidam	دوییدم	#exact
dokhtar	دختر	#exact
dokhtaraiie	دختراییه	#exact
dokhtare	دختر	#exact
dokhtaret	دخترت	#exact
dokhtaroone	دخترونه	#exact
dokhtrashun	دختراشون	#exact
dollar	دلار	#exact
dombale	دمباله	دنبال	#exact
donbale	دنبال	#exact
done	دونه	دان	done	#exact
donya	دنیا	#exact
donyast	دنیاست	#exact
donyaye	دنیای	#exact
dookhtam	دوختم	#exact
doone	دونه	#exact
doorish	دوریش	#exact
dooroogh	دروغ	#exact
dooroogh	دروغ	#exact
doos	دوس	#exact
doosesh	دوسش	#exact
dooset	دوست	#exact
doost	دوست	#exact
doostam	دوستم	#exact
doostan	دوستان	#exact
doostane	دوستانه	دوستان	#exact
doostaye	دوستای	#exact
doostdar	دوستدار	#exact
dooste	دوست	#exact
doostesh	دوستش	#exact
dorood	درود	#exact
dorosht	درست	#exact
dorost	درست	#exact
doroste	درسته	#exact
dorostesh	درستش	#exact
doshmanet	دشمنت	#exact
dosstane	دوستانه	دوستان	#exact
dost	دوست	#exact
dostaan	دوستان	#exact
dostaani	دوستانی	#exact
dostan	دوستان	#exact
dota	دوتا	#exact
dotaashoon	دوتاشون	#exact
dovom	دوم	#exact
dovoman	دوما	#exact
download	دانلود	download	#exact
downlod	دانلود	download	#exact
dozd	دزد	#exact
dozdide	دزدیده	#exact
dozesh	دوزش	#exact
dr	در	دکتر	#exact
drawer	دراور	#exact
drive	درایو	drive	#exact
drop	دراپ	رها کردن	drop	#exact
dubei	دوبی	دبی	#exact
dust	دوست	#exact
dustet	دوستت	#exact
ealam	اعلام	#exact
ebio	ابی‌و	ابی	#exact
ebtekarat	ابتکارت	#exact
edam	اعدام	#exact
edame	ادامه	#exact
ee	ای	ائی	#exact
eftekhar	افتخار	#exact
eghragh	اغراق	#exact
eghtesade	اقتصاد	اقتصادی	#exact
eh	اه	#exact
eheki	اهکی	#exact
ehsaasaat	احساسات	#exact
ehsas	احساس	#exact
ehsasi	احساسی	#exact
ehtemalat	احتمالات	#exact
ehtemale	احتمال	#exact
eib	عیب	#exact
eide	عید	#exact
eidet	عیدت	#exact
eii	اِی	آای	#exact
ein	عین	#exact
eine	عین	#exact
ejra	اجرا	#exact
ejtemaee	اجتماعی	#exact
elam	اعلام	#exact
elika	الیکا	#exact
ellale	علل	#exact
email	ایمیل	پست الکترونیک	E-main	#exact
emailhaye	ایمیل‌های	#exact
emam	امام	#exact
emergency	امرجنسی	ضروری	emergency	#exact
emkane	امکان	#exact
emrooz	امروز	#exact
emroozam	امروزم	#exact
emroz	امروز	#exact
emsal	امسال	#exact
emshab	امشب	#exact
emtedade	امتداد	#exact
emtehan	امتحان	#exact
emtehana	امتحانا	#exact
emtehanam	امتحانام	#exact
emtehanam	امتحانم	#exact
emtehanetono	امتحانتونو	#exact
en	این	انگلیسی	ای.ان	en	#exact
enam	اینم	#exact
endakht	انداخت	#exact
endakhte	انداخته	#exact
energy	انرژی	#exact
engar	انگار	#exact
enghad	اینقد	#exact
enghade	انقده	#exact
engilisi	انگیلیسی	انگلیسی	#exact
englishe	انگلیشه	#exact
enjam	انجام	#exact
enkeh	اینکه	#exact
ensan	انسان	#exact
ensane	انسان	#exact
enshaalaah	انشاالله	#exact
enshalah	انشاالله	#exact
entesab	انتصاب	انتساب	#exact
entezaratam	انتظاراتم	#exact
entezaresho	انتظارشو	#exact
ericsson	اریکسون	erocsson	#exact
ershad	ارشاد	#exact
ertebate	ارتباط	#exact
esfahani	اصفهانی	#exact
eshgh	عشق	#exact
eshgham	عشقم	#exact
eshghe	عشق	عشقه	#exact
eshtebah	اشتباه	#exact
eskandari	اسکندری	#exact
eskandari	اسکندری	#exact
eslah	اصلاح	#exact
eslamshahr	اسلامشهر	#exact
esm	اسم	#exact
esmam	اسمم	#exact
esme	اسم	#exact
esmesh	اسمش	#exact
esmesho	اسمشو	#exact
esmeshoo	اسمشو	#exact
estefaadeh	استفاده	#exact
estefade	استفاده	#exact
esteghrar	استقرار	#exact
estehale	استحاله	#exact
etefaaghan	اتفاقا	#exact
etefagh	اتفاق	#exact
etefaghati	اتفاقاتی	#exact
etefaghi	اتفاقی	#exact
eteghadam	اعتقادم	#exact
eteghadhaye	انتقادهای	#exact
etelaatemun	اطلاعاتمون	#exact
etemad	اعتماد	#exact
eteraz	اعتراض	#exact
ettefaghe	اتفاق	#exact
ey	ای	#exact
eyalate	ایالات	ایالت	#exact
eyde	عید	#exact
eyne	عین	این	#exact
eyval	ایول	#exact
ezafe	اضافه	#exact
ezafeh	اضافه	#exact
ezaye	ازای	#exact
ezdevaj	ازدواج	#exact
faeze	فائزه	فاز	#exact
faghat	فقط	#exact
faghat	فقط	#exact
faheshe	فاحشه	#exact
fahme	فهم	فهمه	#exact
fahmid	فهمید	#exact
fahmidam	فهمیدم	#exact
fahmide	فهمید	#exact
fahmidi	فهمیدی	#exact
faile	فایل	#exact
fajee	فاجعه	فاجعی	#exact
famil	فامیل	#exact
famile	فامیل	#exact
faqat	فقط	#exact
far	فر	فار	#exact
fara	فرا	#exact
faranceh	فرانسه	#exact
farar	فرار	#exact
farari	فراری	#exact
farc	فارسی	#exact
fard	فرد	#exact
farda	فردا	#exact
fardaye	فردای	#exact
fargh	فرق	#exact
farghi	فرقی	#exact
farhang	فرهنگ	#exact
farhangi	فرهنگی	#exact
farhango	فرهنگو	#exact
farhikhtegan	فرهیختگان	#exact
farnaz	فرناز	#exact
fars	فارس	#exact
farshad	فرشاد	#exact
farsi	فارسی	#exact
fart	فرط	#exact
faryad	فریاد	#exact
farzadi	فرزادی	#exact
fateme	فاطمه	#exact
feature	فیچر	خصوصیت	feature	#exact
feel	فعل	#exact
feghat	فقط	#exact
feghdane	فقدان	#exact
fek	فک	#exact
fekr	فکر	#exact
fekra	فکرا	#exact
fekram	فکرم	#exact
fekranast	فکرانست	#exact
fekre	فکر	#exact
fekresho	فکرشو	#exact
fekri	فکری	#exact
felaan	فلان	فعلا	#exact
felan	فعلا	فلان	#exact
fereshteyi	فرشته‌ای	فرشته‌یی	#exact
ferestadam	فرستادم	#exact
fert	فرت	فرط	#exact
fieldesho	فیلدشو	#exact
file	فایل	file	#exact
film	فیلم	#exact
filmaye	فیلمای	فیلمهای	#exact
filme	فیلم	#exact
filmi	فیلمی	#exact
filmo	فیلمو	#exact
fine	فاین	#exact
finglish	فینگلیش	#exact
finglishi	فینگلیشی	#exact
flash	فلش	flash	#exact
floppy	فلاپی	floppy	#exact
fogholaadash	فوق‌الآدش	#exact
fogholadast	فوق‌الآدست	#exact
fogholade	فوق‌العاده	#exact
fogholadeh	فوق‌العاده	#exact
fohsh	فحش	#exact
font	فونت	font	#exact
fonte	فونت	#exact
foozooli	فوضولی	#exact
for	فور	برای	for	#exact
forooshha	فروشها	#exact
forsat	فرصت	#exact
forum	فرم	forum	#exact
forum	فروم	forum	#exact
france	فرانس	فرانسه	france	#exact
free	فیری	مجانی	free	#exact
frestad	فرستاد	#exact
friday	فرایدی	جمعه	friday	#exact
friend	فرند	دوست	friend	#exact
friend	فرند	دوست	friend	#exact
friendship	فرندشیپ	friendship	#exact
full	فول	کامل	full	#exact
gallery	گالری	gallery	#exact
gaman	گمان	#exact
gand	گند	#exact
gardesh	گردش	#exact
gardoondan	گردوندن	#exact
garm	گرم	#exact
gashtam	گشتم	#exact
gavi	گاوی	#exact
gerayeshe	گرایش	#exact
gereft	گرفت	#exact
gereftam	گرفتم	#exact
gereftan	گرفتن	#exact
gerefte	گرفته	#exact
gereftegi	گرفتگی	#exact
gereftegie	گرفتگیه	گرفتگی	#exact
gereftegy	گرفتگی	#exact
gerefteh	گرفته	#exact
gerefti	گرفتی	#exact
gereh	گره	#exact
gerftane	گرفتن	#exact
gerfti	گرفتی	#exact
geyre	غیره	غیر	#exact
ghaaeme	قائمه	#exact
ghabeliyate	قابلیت	#exact
ghabl	قبل	#exact
ghablan	قبلا	#exact
ghablana	قبلنا	#exact
ghable	قبل	#exact
ghabli	قبلی	#exact
ghabol	قبول	#exact
ghabool	قبول	#exact
ghadam	قدم	#exact
ghadimam	قدیمم	#exact
ghado	قدو	قد	#exact
ghadr	قدر	#exact
ghael	قائل	#exact
ghahr	قهر	#exact
ghahve	قهوه	#exact
ghalataye	غلطای	#exact
ghalatgiro	غلتگیرو	غلتگیر	#exact
ghalbe	قلب	#exact
ghalme	قلم	#exact
gham	غم	#exact
ghamat	قامت	غمت	#exact
ghame	غم	قمه	#exact
ghamgin	غمگین	#exact
ghamgini	غمگینی	#exact
ghami	غمی	#exact
ghanimat	غنیمت	#exact
ghanon	قانون	#exact
gharar	قرار	#exact
gharashmish	قاراشمیش	#exact
gharbi	غربی	#exact
ghargh	غرق	#exact
gharibe	غریبه	غریب	#exact
gharibie	قریبی	غریبی	#exact
ghasedak	قاصدک	#exact
ghashange	قشنگه	قشنگ	#exact
ghashangesh	قشنگش	#exact
ghat	قطع	قاط	#exact
ghatan	قطعا	قاطن	#exact
ghatan	قطعا	#exact
ghatre	قطره	#exact
ghavitare	قویتره	#exact
ghavitarin	قویترین	#exact
ghaza	غذا	#exact
ghazaye	غذای	#exact
ghazie	قضیه	#exact
ghazzal	غزل	#exact
ghelyoon	قلیون	غلیون	#exact
ghermez	قرمز	#exact
ghese	قصه	#exact
ghesmat	قسمت	#exact
ghesmate	قسمت	#exact
ghesmatet	قسمتت	#exact
ghesmati	قسمتی	#exact
ghestame	قسطمه	قسطم	#exact
gheymate	قیمت	#exact
gheymatesh	قیمتش	#exact
gheyre	غیر	غیره	#exact
ghiafam	قیافم	#exact
ghiyafam	قیافم	#exact
ghiyafasham	قیافشم	#exact
ghodrat	قدرت	#exact
ghol	قول	غول	قل	#exact
gholdor	قلدر	#exact
ghole	قول	غول	قوله	غوله	#exact
gholombe	قلمبه	#exact
ghoole	غول	قول	#exact
ghor	غر	قر	#exact
ghorbanat	قربانت	#exact
ghorboonet	قربونت	#exact
ghorbooni	قربونی	#exact
ghorbunet	قربونت	#exact
ghose	غصه	#exact
ghyafei	قیافه‌ای	#exact
giafash	قیافش	#exact
gije	گیجه	گیج	#exact
gije	گیجه	گیج	#exact
gir	گیر	#exact
giri	گیری	#exact
go	گو	برو	go	#exact
god	گود	گاد	خدا	god	#exact
godaz	گداز	#exact
gof	گف	گفت	#exact
goft	گفت	#exact
goftam	گفتم	#exact
goftan	گفتن	#exact
gofte	گفته	گفت	#exact
gofteh	گفته	#exact
gofti	گفتی	#exact
goftim	گفتیم	#exact
gofto	گفتو	گفت	#exact
gofty	گفتی	#exact
goh	گه	گوه	#exact
gol	گل	گول	#exact
golden	گلدن	#exact
gole	گل	#exact
goli	گلی	#exact
golii	گلی	#exact
goloole	گلوله	#exact
gom	گم	#exact
gomi	گمی	قمی	#exact
gonah	گناه	#exact
gonde	گنده	#exact
goo	گو	گوی	#exact
good	گود	خوب	khob	#exact
google	گوگل	google	#exact
googooli	گوگولی	#exact
goonehamo	گونه‌هامو	#exact
goosfand	گوسفند	#exact
goosh	گوش	#exact
goosham	گوشم	#exact
gooshei	گوشه‌ای	گوشی	#exact
gooshi	گوشی	#exact
gooyandegi	گویندگی	#exact
gorgan	گرگان	#exact
gorosne	گرسنه	#exact
gosari	گساری	#exact
gosasteye	گسسته‌ی	#exact
gosh	گوش	#exact
goshe	گوش	گوشه	#exact
goshnam	گشنم	#exact
goushe	گوش	گوشه	#exact
gozari	گذاری	#exact
gozasht	گذاشت	گذشت	#exact
gozashte	گذشته	#exact
gozashteh	گذشته	#exact
gozashti	گذاشتی	#exact
gozashtim	گذاشتیم	گذشتیم	#exact
grid	گرید	grid	#exact
group	گروپ	گروه	group	#exact
gui	گوی	واسط کاربر	GUI	#exact
gush	گوش	#exact
ha	ها	#exact
had	حد	حاد	#exact
hadafe	هدف	هدفه	#exact
hadafeshono	هدفشونو	#exact
hadafet	هدفت	#exact
hadde	حد	#exact
hade	حد	حاد	#exact
hads	حدس	#exact
hafez	حافظ	#exact
haftad	هفتاد	#exact
hafte	هفته	#exact
hafte	هفته	#exact
hafteh	هفته	#exact
haftehee	هفتهه	هفته‌ای	هفته‌ی	#exact
hafteye	هفته‌ی	#exact
hagh	حق	#exact
haghighat	حقیقت	#exact
haghighat	حقیقت	#exact
haghighate	حقیقت	#exact
hagho	حقو	#exact
hai	های	#exact
haji	حاجی	#exact
hal	حال	حل	#exact
hala	حالا	#exact
halaha	حالاها	#exact
halam	حالم	#exact
halamo	حالمو	#exact
hale	حال	حله	#exact
halesh	حالش	#exact
halesho	حالشو	#exact
halet	حالت	#exact
halghe	حلقه	#exact
hali	حالی	#exact
hall	حال	#exact
halloween	هالوین	halloween	#exact
ham	هم	هام	#exact
hamamon	هممون	#exact
hamamoon	هممون	#exact
haman	همان	#exact
hamao	همه‌و	#exact
hamash	همش	#exact
hamashoon	همشون	#exact
hamatoon	همتون	#exact
hamchenan	همچنان	#exact
hamchin	همچین	#exact
hamdigaro	همدیگرو	#exact
hamdige	همدیگه	#exact
hame	همه	#exact
hamechizeto	همچیزتو	#exact
hamegi	همگی	#exact
hameh	همه	#exact
hameye	همه‌ی	همه	#exact
hamin	همین	#exact
haminam	همینم	#exact
hamine	همینه	#exact
haminjoori	همینجوری	#exact
haminjori	همینجوری	#exact
hamintor	همینطور	#exact
hamintori	همینطوری	#exact
hamishe	همیشه	#exact
hamishegi	همیشگی	#exact
hamisheh	همیشه	#exact
hamkara	همکارا	#exact
hamkaram	همکارم	همکارام	#exact
hamkaranesh	همکارانش	#exact
hamkelasi	همکلاسی	#exact
hamkhooni	همخونی	#exact
hamle	حمله	#exact
hamo	همو	هامو	#exact
hamon	همون	#exact
hamoon	همون	#exact
hamoonjaa	همونجا	#exact
hamoontor	همونطور	#exact
hamoun	همون	#exact
hamrahe	همراه	#exact
hamsaye	همسایه	#exact
hamsayehaye	همسایه‌های	#exact
hamun	همون	#exact
hamuni	همونی	#exact
han	هان	#exact
hanooz	هنوز	#exact
hanoz	هنوز	#exact
haq	حق	#exact
har	هر	#exact
harche	هرچه	#exact
harchi	هرچی	#exact
harchizi	هرچیزی	#exact
harf	حرف	#exact
harfa	حرفا	#exact
harfaaye	حرفای	حرفایه	#exact
harfamo	حرفمو	#exact
harfasho	حرفاشو	#exact
harfast	حرفاست	#exact
harfato	حرفاتو	#exact
harfe	حرف	#exact
harja	هرجا	#exact
harjaye	هرجای	#exact
harkario	هرکاریو	#exact
harkas	هرکس	#exact
harkodom	هرکدوم	#exact
harmale	حرمله	#exact
haro	هارو	#exact
haroomzade	حرومزاده	#exact
harvaght	هروقت	#exact
harvard	هاروارد	harvard	#exact
harze	هرزه	#exact
hasan	حسن	#exact
hasho	هاشو	حشو	#exact
hasoodi	حسودی	#exact
hasrat	حسرت	#exact
hassasam	حساسم	#exact
hasstyo	هستیو	#exact
hassy	حسی	#exact
hast	هست	#exact
hastam	هستم	#exact
hastan	هستن	#exact
hastand	هستند	#exact
hastesh	هستش	#exact
hasti	هستی	#exact
hastim	هستیم	#exact
hastima	هستیما	#exact
hata	حتی	#exact
hataa	حتا	#exact
hatman	حتما	#exact
hatta	حتی	#exact
hatta	حتی	#exact
hava	هوا	#exact
havaie	هوایی	#exact
havas	حواس	هوس	#exact
havaset	حواست	#exact
hayajanzade	هیجان‌زده	#exact
haye	های	#exact
hayejan	هیجان	#exact
hayejani	هیجانی	#exact
hazeram	حاضرم	#exact
hazf	حذف	#exact
hazineye	هزینه‌ی	هزینه	#exact
hazrate	حضرت	#exact
hediye	هدیه	#exact
hedye	هدیه	#exact
hefz	حفظ	#exact
heif	حیف	#exact
hello	هلو	سلام	hello	#exact
help	هلپ	کمک	help	#exact
hemaghatesh	حماقتش	#exact
hemati	همتی	#exact
hend	هند	#exact
hendoonashoon	هندونشون	#exact
hendoone	هندونه	#exact
herasate	حراست	#exact
herfei	حرفه‌ای	#exact
hers	حرص	#exact
hersesh	حرصش	#exact
hersi	حرصی	#exact
hesab	حساب	#exact
hesabi	حسابی	#exact
hesabras	حسابرس	#exact
hesaby	حسابی	#exact
hese	حس	#exact
hesesh	حسش	#exact
hesse	حسه	حس	#exact
hey	هی	#exact
hezar	هزار	#exact
hezaran	هزاران	#exact
hezaromeshe	هزارمشه	#exact
hich	هیچ	#exact
hichi	هیچی	#exact
hichkas	هیچکس	#exact
hichki	هیچکی	#exact
high	های	بالا	high	#exact
hih	هیه	#exact
hiich	هییچ	#exact
hodoudan	حدودا	#exact
holiday	هالیدی	تعطیلات	holiday	#exact
hollywood	هالیوود	#exact
home	حومه	هوم	home	#exact
honar	هنر	#exact
honari	هنری	#exact
honarmand	هنرمند	#exact
honarmande	هنرمند	#exact
hosein	حسین	#exact
hoseyn	حسین	#exact
hoviati	هویتی	#exact
hozooretoon	حضورتون	#exact
hpc	اچ.پی.سی	HPC	#exact
html	اچ.تی.ام.ال	HTML	#exact
http	اچ.تی.تی.پی	HTTP	#exact
hug	هاگ	#exact
i'm	ایم	#exact
ia	یا	#exact
iadha	یادها	یدها	#exact
iani	یعنی	#exact
id	آی دی	شناسه	ID	#exact
ideal	ایدل	ایدآل	ideal	#exact
idie	ایدیه	آیدی	#exact
idmo	ایدیمو	#exact
ie	یه	#exact
ieki	یکی	#exact
iin	این	#exact
iisa	عیسی	#exact
ijade	ایجاد	#exact
im	ایم	#exact
iman	ایمان	#exact
imano	ایمانو	#exact
impact	ایمپکت	تاثیر	impact	#exact
in	این	#exact
ina	اینا	#exact
inaii	اینایی	#exact
inam	اینم	#exact
inaro	اینارو	#exact
inch	اینچ	#exact
ine	اینه	#exact
ineh	اینه	#exact
ineke	اینه‌که	اینکه	#exact
inghadar	اینقدر	#exact
inghadr	اینقدر	#exact
inja	اینجا	#exact
injam	اینجام	#exact
injan	اینجان	#exact
injast	اینجاست	#exact
injoore	اینجوره	#exact
injoori	اینجوری	#exact
injori	اینجوری	#exact
injorie	اینجوریه	#exact
injurie	اینجوریه	اینجوری	#exact
inkareie	اینکاره‌ا‌ی	#exact
inke	اینکه	#exact
inkeh	اینکه	#exact
ino	اینو	#exact
inspiron	اینسپایرون	inspiron	#exact
international	اینترنشنال	بین‌المللی	international	#exact
internet	اینترنت	internet	#exact
intoori	اینطوری	#exact
intori	اینطوری	#exact
intoriast	اینطوریاست	#exact
intorie	اینطوریه	#exact
invar	اینور	#exact
inyeki	این‌یکی	#exact
ip	آی پی	IP	#exact
iphone	آیفون	iphone	#exact
irad	ایراد	#exact
iradaye	ایرادای	#exact
iran	ایران	#exact
irani	ایرانی	#exact
iranie	ایرانیه	ایرانی	#exact
is	ایز	ایس	#exact
ishon	ایشون	#exact
ishonam	ایشونم	#exact
israeliie	اسرائیلیه	#exact
istgah	ایستگاه	#exact
istgahe	ایستگاه	#exact
it	ایت	آن	it	#exact
italia	ایتالیا	#exact
italy	ایتالی	#exact
j2me	جی تو ام ای	J2ME	#exact
ja	جا	#exact
jaadoyish	جادوییش	#exact
jaan	جان	#exact
jadalo	جدلو	#exact
jadid	جدید	#exact
jadida	جدیدا	#exact
jadidam	جدیدم	#exact
jadidi	جدیدی	#exact
jado	جادو	#exact
jae	جای	جاع	#exact
jaee	جایی	#exact
jaeeze	جایزه	#exact
jahan	جهان	#exact
jahate	جهت	#exact
jaie	جای	#exact
jaii	جایی	#exact
jalase	جلسه	#exact
jaleb	جالب	#exact
jalebi	جالبی	#exact
jam	جم	#exact
jame	جامع	جامعه	#exact
jamee	جامعه	جامی	#exact
jan	جان	#exact
janbe	جنبه	#exact
jaro	جارو	#exact
jaryan	جریان	#exact
jaryane	جریان	#exact
jashe	جاشه	#exact
jasho	جاش‌و	جاشو	#exact
jasus	جاسوس	#exact
jat	جات	#exact
jatoon	جاتون	#exact
java	چاوا	java	#exact
javab	جواب	#exact
javaba	جوابا	#exact
javabamo	جوابمو	#exact
javabe	جواب	#exact
javabesho	جوابشو	#exact
jay	جای	#exact
jaye	جای	#exact
jayee	جایی	#exact
jayeze	جایزه	#exact
jazabi	جذابی	#exact
jazabiati	جذابیتی	#exact
jeddan	جدا	#exact
jeddi	جدی	#exact
jelo	جلو	#exact
jenaiat	جنایت	جنایات	#exact
jende	جنده	#exact
jensi	جنسی	#exact
jigaret	جیگرت	#exact
jodaee	جدایی	جدائی	#exact
join	جوین	وصل	join	#exact
jok	جوک	#exact
joke	جک	#exact
joker	جوکر	#exact
joloye	جلوی	#exact
jom'ast	جمعست	#exact
jom'e	جمعه	#exact
jomalate	جملات	#exact
jome	جمعه	#exact
jomlato	جملتو	#exact
jomle	جمله	#exact
jomleh	جمله	#exact
jomlehayi	جمله‌هایی	#exact
jomleyee	جمله‌ای	#exact
joon	جون	#exact
joonam	جونم	#exact
jooni	جونی	#exact
joor	جور	#exact
jooraie	جورای	جورائی	#exact
jooreshe	جورشه	جورش	#exact
joori	جوری	#exact
jor	جور	#exact
jore	جور	#exact
jori	جوری	#exact
jorme	جرم	جرمه	#exact
jory	جوری	#exact
joz	جز	#exact
jozeiatesh	جزئیاتش	#exact
jozeishe	جزئیشه	جزئیش	#exact
jozve	جزو	جزوه	#exact
jul	جول	جولای	jul	#exact
july	جولای	جولی	july	#exact
june	جون	#exact
just	جاست	فقط	just	#exact
kaamelan	کاملا	#exact
kaaraaye	کارایه	کارای	#exact
kabk	کبک	#exact
kabkan	کبکن	کبکان	#exact
kac	کسی	کک	#exact
kadeh	کده	#exact
kajravi	کجروی	#exact
kalamate	کلمات	#exact
kalameye	کلمه‌ی	کلمه	#exact
kale	کله	کل	#exact
kam	کم	کام	#exact
kamar	کمر	#exact
kame	کمه	کام	#exact
kamel	کامل	#exact
kamelan	کاملا	#exact
kami	کمی	#exact
kamran	کامران	#exact
kamtar	کمتر	#exact
kandast	کندست	#exact
kande	کنده	#exact
kar	کار	#exact
kara	کارا	#exact
karadam	کردم	#exact
karam	کارم	#exact
karamo	کارامو	کارمو	#exact
karas	کارس	#exact
karaye	کارای	#exact
kard	کرد	#exact
kardam	کردم	#exact
kardan	کردن	#exact
kardanam	کردنم	#exact
kardane	کردن	#exact
kardd	کرد	#exact
karde	کرده	#exact
kardeh	کرده	#exact
kardi	کردی	#exact
kardid	کردید	#exact
kardim	کردیم	#exact
kardin	کردین	#exact
kardio	کردیو	#exact
kardy	کردی	#exact
kare	کار	کر	کره	#exact
karemoono	کارامونو	#exact
karesh	کارش	#exact
karet	کارت	#exact
kargardan	کارگردان	#exact
karha	کارها	#exact
karhai	کارهایی	کارهای	#exact
karhash	کارهاش	#exact
kari	کاری	#exact
kario	کاریو	#exact
karish	کاریش	#exact
karmande	کارمند	#exact
karo	کار	کر	#exact
kartaye	کارتای	#exact
karte	کارت	#exact
kary	کاری	#exact
kas	کس	#exact
kasani	کسانی	#exact
kash	کاش	#exact
kashef	کاشف	#exact
kashi	کاشی	#exact
kashki	کاشکی	#exact
kasi	کسی	#exact
kasio	کسیو	#exact
kassiye	کسیه	کسی	#exact
kastan	کاستن	#exact
katalogue	کاتالوگ	#exact
kavi	کاوی	#exact
kavir	کویر	#exact
kazaai	کذایی	#exact
kazaay	کزای	#exact
ke	که	#exact
keh	که	#exact
keie	که‌ی	کیه	#exact
keifiate	کیفیت	#exact
keiko	کیکو	#exact
kelas	کلاس	#exact
kelasi	کلاسی	#exact
kenar	کنار	#exact
kenaram	کنارم	#exact
kenare	کنار	#exact
kenaremoon	کنارمون	#exact
keraye	کرایه	#exact
kerkerehaye	کرکرهای	#exact
keshidan	کشیدن	#exact
keshidanesh	کشیدنش	#exact
keshidid	کشیدید	#exact
keshidin	کشیدین	#exact
keshido	کشیدو	#exact
keshvar	کشور	#exact
keshvarhaii	کشورهایی	#exact
keshwar	کشور	#exact
kesi	کسی	#exact
ketaab	کتاب	#exact
ketab	کتاب	#exact
ketabaro	کتابارو	کتابرو	#exact
ketabe	کتاب	#exact
ketabkhooneo	کتابخونه‌و	#exact
key	کی	#exact
keyf	کیف	#exact
keyfiate	کیفیت	#exact
keyvan	کیوان	#exact
khaabi	خوابی	#exact
khaahad	خواهد	#exact
khaaham	خواهم	#exact
khaalam	خالم	#exact
khaalie	خالیه	خالی	#exact
khaalit	خالیت	#exact
khaanade	خنده	#exact
khaanande	خواننده	#exact
khaanvaadame	خانوادم	خانوادمه	#exact
khaareji	خارجی	#exact
khab	خواب	#exact
khabar	خبر	#exact
khabara	خبرا	#exact
khabare	خبر	خبره	#exact
khabargozari	خبرگزاری	#exact
khabari	خبری	#exact
khabe	خواب	خوابه	#exact
khabet	خوابت	#exact
khabeto	خوابتو	#exact
khabgahemoon	خوابگاهمون	#exact
khabidam	خوابیدم	#exact
khafan	خفن	#exact
khafe	خفه	#exact
khahad	خواهد	#exact
khaham	خواهم	#exact
khaharash	خواهرش	#exact
khahare	خواهر	#exact
khaharha	خواهرها	#exact
khahesh	خواهش	#exact
khaili	خیلی	#exact
khak	خاک	#exact
khaki	خاکی	#exact
khalas	خلاص	#exact
khale	خاله	#exact
khaleo	خاله‌و	#exact
khali	خالی	#exact
khalie	خالیه	#exact
khaliye	خالیه	خالی	#exact
khallaghiyyate	خلاقیت	#exact
khalvat	خلوت	#exact
khamush	خاموش	#exact
khan	خان	#exact
khanandeh	خواننده	#exact
khanandehaa	خواننده‌ها	#exact
khanandehi	خواننده‌ای	#exact
khanandeye	خواننده‌ی	خواننده	#exact
khande	خنده	خوانده	#exact
khandeye	خنده‌ی	خنده	#exact
khandidam	خندیدم	#exact
khane	خانه	#exact
khanomi	خانومی	خانمی	#exact
khanoom	خانوم	#exact
khanoome	خانوم	خانومه	#exact
khar	خر	#exact
kharab	خراب	#exact
kharabe	خرابه	خراب	#exact
kharabetam	خرابتم	#exact
kharabkari	خراب‌کاری	#exact
kharabtar	خرابتر	#exact
khareji	خارجی	#exact
khari	خری	خاری	#exact
kharid	خرید	#exact
kharidam	خریدم	#exact
kharide	خرید	خریده	#exact
kharidim	خریدیم	#exact
khashme	خشم	#exact
khast	خواست	#exact
khastand	خواستند	#exact
khastash	خواستش	#exact
khaste	خسته	#exact
khastegari	خواستگاری	#exact
khasteh	خسته	#exact
khat	خط	#exact
khate	خط	خطه	#exact
khatere	خاطر	خاطره	#exact
khatoon	خاتون	#exact
khedmat	خدمت	#exact
kheeili	خیلی	#exact
kheili	خیلی	#exact
kheilii	خیلی	#exact
kheli	خیلی	#exact
khertto	خرتو	#exact
kheyli	خیلی	#exact
kheylia	خیلیا	خیلی‌ها	#exact
khiaboon	خیابون	#exact
khiaboone	خیابون	#exact
khialati	خیالاتی	#exact
khiale	خیال	خیاله	#exact
khire	خیره	#exact
khiyabone	خیابون	#exact
khob	خوب	#exact
khobe	خوبه	#exact
khobeh	خوبه	#exact
khobi	خوبی	#exact
khobie	خوبیه	خوبی	#exact
khod	خود	#exact
khoda	خدا	#exact
khodafez	خدافظ	#exact
khodafezi	خدافظی	خداحافظی	#exact
khodai	خدایی	خدای	#exact
khodam	خودم	#exact
khodame	خودمه	#exact
khodamo	خودمو	#exact
khodaya	خدایا	#exact
khodaye	خدای	خدایی	#exact
khode	خود	خوده	#exact
khodemoon	خودمون	#exact
khodemoono	خودمونو	#exact
khodesh	خودش	#exact
khodesham	خودشم	#exact
khodesho	خودشو	#exact
khodeshon	خودشون	#exact
khodeshoon	خودشون	#exact
khodeshun	خودشون	#exact
khodet	خودت	#exact
khodete	خودت	خودته	#exact
khodeti	خودتی	#exact
khodeto	خودتو	#exact
khodetonro	خدتونرو	#exact
khodetoon	خودتون	#exact
khodkaramo	خودکارمو	#exact
khodshono	خودشنو	#exact
kholaaase	خلاصه	#exact
kholase	خلاصه	#exact
khonak	خنک	#exact
khond	خوند	#exact
khondam	خوندم	#exact
khondi	خوندی	#exact
khone	خونه	#exact
khoneye	خونه‌ی	خونه	#exact
khoneyee	خونه‌ی	#exact
khoob	خوب	#exact
khoob	خوب	#exact
khoobam	خوبم	#exact
khoobe	خوبه	خوب	#exact
khoobeh	خوبه	#exact
khoobemoon	خوبمون	#exact
khoobi	خوبی	#exact
khoobia	خوبیا	#exact
khoobie	خوبیه	خوبی	#exact
khoobiye	خوبیه	خوبی	#exact
khoobo	خوبو	#exact
khoonam	خونم	#exact
khoonashoono	خونشونو	#exact
khoonato	خونتو	#exact
khoond	خوند	#exact
khoondam	خوندم	#exact
khoondan	خوندن	#exact
khoondan	خوندن	#exact
khoondan	خوندن	#exact
khoondane	خوندن	#exact
khoondanesh	خوندنش	#exact
khoone	خونه	خون	#exact
khooneh	خونه	#exact
khoonehamoon	خونه‌هامون	#exact
khooneye	خونه‌ی	#exact
khoono	خونو	#exact
khoord	خورد	#exact
khoosh	خوش	#exact
khord	خورد	#exact
khordam	خوردم	#exact
khordamo	خوردمو	#exact
khordan	خوردن	#exact
khorde	خورده	#exact
khordim	خوردیم	#exact
khosh	خوش	#exact
khoshalin	خشالین	خشحالین	#exact
khosham	خوشم	#exact
khoshbakhtane	خوشبختانه	#exact
khoshbakhti	خوشبختی	#exact
khoshe2n	خشتون	#exact
khoshet	خوشت	#exact
khoshetoon	خوشتون	#exact
khoshgel	خوشگل	#exact
khoshgelam	خوشگلم	#exact
khoshgele	خشگله	خوشگل	#exact
khoshgele	خشگله	#exact
khoshgeleh	خوشگله	#exact
khoshgelo	خوشگلو	#exact
khoshhaal	خوشحال	خوشال	#exact
khoshhal	خوشحال	#exact
khoshhalam	خوشحالم	#exact
khoshhali	خوشحالی	#exact
khoshk	خشک	#exact
khoshkel	خوشکل	#exact
khoshmaze	خوشمزه	#exact
khoshtip	خوش‌تیپ	خوشتیپ	#exact
khosoos	خصوص	#exact
khoubi	خوبی	#exact
khoundane	خوندن	#exact
khounde	خونده	#exact
khub	خوب	#exact
khubam	خوبم	#exact
khube	خوبه	#exact
khubi	خوبی	#exact
khundam	خوندم	#exact
khunde	خونده	خوانده	#exact
khune	خونه	#exact
khyly	خیلی	#exact
ki	کی	#exact
kie	کیه	#exact
kilometeri	کیلومتری	#exact
king	کینگ	شاه	king	#exact
kise	کیسه	#exact
kiss	کیس	بوس	بوسه	kiss	#exact
kiye	کیه	#exact
kkhali	خالی	#exact
klik	کلیک	click	#exact
kocholomo	کوچولومو	#exact
kocholoo	کوچولو	#exact
kodam	کدام	#exact
kodametan	کدامتان	#exact
kodom	کدوم	#exact
kodomeshon	کدومشون	#exact
kodoom	کدوم	#exact
kodum	کدوم	#exact
kofr	کفر	#exact
koja	کجا	#exact
kojaa	کجا	#exact
kojae	کجای	#exact
kojaha	کجاها	#exact
kojast	کجاست	#exact
kol	کل	#exact
kolan	کلاٌ	#exact
kole	کل	#exact
koli	کلی	#exact
kolish	کلیش	#exact
kolita	کلیتا	#exact
kollan	کلا	#exact
kolli	کلی	#exact
komak	کمک	#exact
komakam	کمکم	#exact
kon	کن	#exact
konam	کنم	#exact
konan	کنن	#exact
konand	کنند	#exact
konande	کننده	کنند	#exact
kone	کنه	#exact
koni	کنی	#exact
konid	کنید	#exact
konied	کنید	#exact
konim	کنیم	کنیم	#exact
konim	کنیم	#exact
konin	کنین	#exact
konj	کنج	#exact
konkoor	کنکور	#exact
konkoor	کنکور	#exact
konkor	کنکور	#exact
konkour	کنکور	#exact
konm	کنم	#exact
koo	کو	#exact
koochik	کوچیک	#exact
koochiko	کوچیک‌و	#exact
koochooloote	کوچولوته	کوچولوت	#exact
koochuloo	کوچولو	#exact
koodoom	کودوم	کدوم	#exact
koodoomo	کودومو	کدومو	#exact
koohe	کوه	#exact
kooli	کولی	کلی	#exact
koor	کور	#exact
koose	کوسه	#exact
kosht	کشت	#exact
koshtar	کشتار	#exact
kotah	کوتاه	#exact
kou	کو	#exact
kuchuluhe	کوچولوه	کوچولوهه	#exact
labkhand	لبخند	#exact
labkhande	لبخند	#exact
labriz	لبریز	#exact
lahze	لحظه	#exact
lak	لاک	لک	#exact
lake	لکه	لک	#exact
land	لند	#exact
laptope	لپ‌تاپ	لپ‌تاپه	#exact
larze	لرزه	لرز	#exact
larzid	لرزید	#exact
last	لاست	لست	قبلی	last	#exact
lat	لات	#exact
latin	لاتین	latin	#exact
lavazeme	لوازم	لوازمه	#exact
layegh	لایق	#exact
lazem	لازم	#exact
left	لفت	#exact
lezat	لذت	#exact
lg	ال.جی	LG	#exact
life	لایف	زندگی	life	#exact
like	لایک	like	#exact
line	لاین	خط	line	#exact
link	لینک	مرتبط	link	#exact
lirycs	لیریکس	#exact
listamo	لیستمو	#exact
liste	لیست	#exact
live	لایو	زنده	live	#exact
lo	لو	#exact
local	لوکال	محلی	local	#exact
location	لوکیشن	#exact
log	لاگ	log	#exact
login	لاگین	ورود	login	#exact
lol	لول	#exact
looti	لوطی	#exact
lord	لرد	#exact
lotf	لطف	#exact
love	لاو	عشق	love	#exact
lyrice	لیریکه	لیریک	lyric	#exact
ma	ما	#exact
ma'soom	معصوم	#exact
maa	ما	#exact
maah	ماه	#exact
maam	مام	#exact
maast	ماست	مست	#exact
mabi	مآبی	#exact
mach	ماچ	مچ	تطبیق	mach	#exact
mache	ماچ	مچ	#exact
mad	مد	ماد	#exact
madar	مادر	مدار	#exact
madararo	مادرارو	#exact
madarim	مادریم	مدارییم	#exact
madi	مادی	#exact
madrese	مدرسه	#exact
madreseh	مدرسه	#exact
maee	مایی	#exact
magazine	مگزینه	#exact
mage	مگه	#exact
maghz	مغز	#exact
maghzesh	مغزش	#exact
maghzeto	مغزتو	#exact
magooli	مگولی	#exact
mah	ماه	#exact
maha	ماها	#exact
mahal	محل	محال	#exact
mahale	محله	محل	#exact
mahaletono	محلتونو	#exact
maham	ماهم	ماهام	#exact
maharathaie	مهارت‌های	مهارت‌هایی	#exact
mahe	ماه	مه	#exact
mahi	ماهی	#exact
mahsoob	محسوب	#exact
mahv	محو	#exact
mahya	مهیا	#exact
mail	میل	پست	mail	#exact
maileto	میلتو	#exact
majale	مجله	#exact
majaleye	مجله‌ی	مجله	#exact
majara	ماجرا	#exact
majboor	مجبور	#exact
majid	مجید	#exact
maketo	ماکتو	#exact
makhsoos	مخصوص	#exact
makhsoosan	مخصوصا	#exact
makhsus	مخصوص	#exact
male	مال	#exact
mali	مالی	#exact
malih	ملیح	#exact
maloom	معلوم	ملوم	#exact
mamalie	مملیه	مملی	#exact
maman	مامان	#exact
mamanam	مامانم	#exact
mamanesh	مامانش	#exact
mamlekati	مملکتی	#exact
mamnon	ممنون	#exact
mamnonam	ممنونم	#exact
mamnonet	ممنونت	#exact
mamnoon	ممنون	#exact
mamnoonam	ممنونم	#exact
mamoolan	معمولا	#exact
mamoolim	معمولیم	ممولیم	#exact
man	من	مان	#exact
manaast	معناست	#exact
manabe	منابع	#exact
manage	منیج	مدیریت	manage	#exact
manager	منیجر	مدیر	manager	#exact
manam	منم	#exact
manavi	معنوی	#exact
manba	منبع	#exact
manbae	منبع	#exact
mane	منه	من	#exact
manhatan	منهتن	#exact
mani	منی	مانی	#exact
manie	معنیه	مانی	#exact
manisho	معنیشو	#exact
mano	منو	#exact
mano	منو	#exact
mansoob	منصوب	منسوب	#exact
mansuro	منصورو	#exact
manzooret	منظورت	#exact
manzor	منظور	#exact
manzuram	منظورم	#exact
manzureto	منظورتو	#exact
mar30	مرسی	مر30	#exact
marame	مرامه	مرام	#exact
marasem	مراسم	#exact
marboot	مربوط	#exact
march	مارچ	مارث	march	#exact
marde	مرد	#exact
mardeshab	مردشب	#exact
mardom	مردم	#exact
mardonegi	مردونگی	#exact
marekeh	معرکه	مرکه	#exact
marg	مرگ	#exact
margam	مرگم	#exact
marhumesh	مرهومش	#exact
maroof	معروف	#exact
marz	مرز	#exact
masalan	مثلا	#exact
masale	مسئله	مساله	#exact
masayel	مسایل	مسائل	#exact
mash	مش	ماش	#exact
mashghe	مشق	#exact
mashghoole	مشغول	مشغوله	#exact
mashhad	مشهد	#exact
mashin	ماشین	#exact
mashinam	ماشینم	#exact
mashine	ماشین	ماشینه	#exact
mashooghe	معشوقه	معشوق	#exact
masih	مسیح	#exact
maskhare	مسخره	#exact
mast	ماست	#exact
mast	مست	#exact
matalebe2no	مطلبتونو	#exact
matlab	مطلب	#exact
matne	متن	#exact
matrah	مطرح	#exact
max	مکث	#exact
maye	مایه	#exact
mayehaye	می‌های	مایه‌های	#exact
mazast	مزست	#exact
maze	مزه	#exact
mazerat	معذرت	#exact
me	می	من	me	#exact
meeting	میتینگ	ملاقات	meeting	#exact
meeting-e	میتینگ	میتینگه	#exact
mehdi	مهدی	#exact
mehr	مهر	#exact
mehrabooni	مهربونی	#exact
mehraboono	مهربونو	#exact
mehran	مهران	#exact
melat	ملت	#exact
melate	ملت	#exact
memare	معماره	معمار	#exact
mentally	منتالی	ذهنی	mentally	#exact
menu	منو	فهرست	Meno	#exact
menuye	منوی	#exact
mer30	مرسی	#exact
merc	مرسی	#exact
merci	مرسی	#exact
mersi	مرسی	#exact
mesalam	مثالم	#exact
mesalan	مثلا	#exact
mese	مثل	مس	#exact
mesengere	مسنجر	پیغام‌آور	messenger	#exact
mesl	مثل	#exact
mesle	مثل	#exact
mesleh	مثل	مثله	#exact
message	مسیج	پیغام	message	#exact
metal	متال	#exact
metro	مترو	#exact
meyam	میام	#exact
mi2nin	می‌تونین	#exact
miaan	میان	#exact
miad	میاد	#exact
miai	میای	#exact
miain	میاین	#exact
miam	میام	#exact
mian	میان	#exact
miaram	میارم	#exact
miaran	میارن	#exact
miare	میاره	#exact
miarzeh	می‌ارزه	میرزه	#exact
miay	میای	#exact
mibande	می‌بنده	میبنده	#exact
mibaram	می‌برم	میبرم	می‌بارم	میبارم	#exact
mibashad	می‌باشد	میباشد	#exact
mibinam	می‌بینم	میبینم	#exact
mibinamesh	می‌بینمش	میبینمش	#exact
mibinanad	می‌بینند	#exact
mibine	میبینه	#exact
mibini	می‌بینی	میبینی	#exact
mibood	می‌بود	میبود	#exact
mibordam	می‌بردم	میبردم	#exact
mibudi	می‌بودی	میبودی	#exact
mic	میسی	#exact
microphone	میکروفن	#exact
mid	مید	#exact
midaadam	میدادم	#exact
midad	می‌داد	میداد	#exact
midam	میدم	#exact
midan	میدن	#exact
midanad	میداند	#exact
midand	میدند	#exact
midashti	میداشتی	#exact
mide	میده	#exact
midi	میدی	#exact
mididam	میدیدم	#exact
mididan	میدیدن	#exact
midim	می‌دیم	میدیم	#exact
midonam	می‌دونم	میدونم	#exact
midonam	می‌دونم	میدونم	#exact
midoni	میدونی	#exact
midoonam	می‌دونم	میدونم	#exact
midoone	می‌دونه	میدونه	#exact
midoonestam	میدونستم	#exact
midooni	میدونی	#exact
midouni	میدونی	#exact
midunam	میدونم	#exact
midunestam	می‌دونستم	میدونستم	#exact
miduni	میدونی	#exact
mifahmam	میفهمم	#exact
mifahme	میفهمه	#exact
mifahmi	می‌فهمی	#exact
mifrestam	میفرستم	#exact
migam	می‌گم	#exact
migan	میگن	#exact
migardam	می‌گردم	میگردم	#exact
migarde	می‌گرده	میگرده	می‌گرد	میگرد	#exact
migardi	می‌گردی	میگردی	#exact
migashtam	می‌گشتم	میگشتم	#exact
mige	میگه	#exact
migeh	می‌گه	میگه	#exact
migereftam	می‌گرفتم	میگرفتم	#exact
migi	میگی	#exact
migim	میگیم	#exact
migin	میگین	#exact
migire	می‌گیره	میگیره	#exact
migirin	میگیرین	#exact
migm	میگم	#exact
migoft	میگفت	#exact
migoftam	می‌گفتم	میگفتم	#exact
migoftan	میگفتن	#exact
migofti	می‌گفتی	میگفتی	#exact
migoftim	می‌گفتیم	میگفتیم	#exact
migoftin	می‌گفتین	#exact
migzaaram	میگذارم	#exact
migzare	میگذره	میگذاره	#exact
migzareh	می‌گذره	میگذره	می‌گذاره	میگذاره	#exact
mikanam	می‌کنم	میکنم	#exact
mikard	می‌کرد	#exact
mikardam	می‌کردم	میکردم	#exact
mikardan	می‌کردن	میکردن	#exact
mikardand	می‌کردند	#exact
mikardim	می‌کردیم	#exact
mikeshan	می‌کشن	میکشن	#exact
mikeshi	می‌کشی	#exact
mikeshid	می‌کشید	میکشید	#exact
mikeshin	میکشین	#exact
mikhad	می‌خواد	میخواد	#exact
mikhai	میخوای	#exact
mikhaie	میخوای	#exact
mikham	می‌خوام	میخوام	#exact
mikhamet	می‌خوامت	میخوامت	#exact
mikhan	میخوان	#exact
mikhanad	می‌خواند	میخواند	#exact
mikhandidam	می‌خندیدم	میخندیدم	#exact
mikhandidim	می‌خندیدیم	میخندیدیم	#exact
mikharam	میخرم	#exact
mikhast	میخواست	#exact
mikhastam	می‌خواستم	میخواستم	#exact
mikhaste	می‌خواسته	#exact
mikhasti	میخواستی	#exact
mikhay	می‌خوای	میخوای	#exact
mikhaym	می‌خوایم	میخوایم	#exact
mikhayn	می‌خواین	#exact
mikhonand	میخونند	#exact
mikhondam	میخوندم	#exact
mikhoneh	میخونه	#exact
mikhorim	می‌خوریم	میخوریم	#exact
mikhoure	می‌خوره	#exact
mikhunam	میخونم	#exact
mikonam	می‌کنم	میکنم	#exact
mikonam	می‌کنم	میکنم	#exact
mikonamesh	می‌کنمش	میکنمش	#exact
mikonan	می‌کنن	#exact
mikone	می‌کنه	میکنه	#exact
mikoneh	میکنه	#exact
mikoni	می‌کنی	#exact
mikonid	می‌کنید	میکنید	#exact
mikonim	می‌کنیم	میکنیم	#exact
mikoonam	می‌کنم	میکنم	#exact
mikoonam	می‌کونم	میکونم	#exact
milade	میلاد	#exact
milinkamet	میلینکمت	#exact
milliardha	میلیاردها	#exact
mimiram	می‌میرم	میمیرم	#exact
mimiran	میمیرن	#exact
mimune	میمونه	#exact
min	مین	دقیقه	min	minute	#exact
mindazam	میندازم	#exact
minevc	مینوسی	#exact
mineveshtam	می‌نوشتم	مینوشتم	#exact
minevisam	می‌نویسم	مینویسم	#exact
minevisan	مینویسن	#exact
mioftam	میفتم	#exact
miofte	میفته	#exact
mioomad	میومد	#exact
mipardazand	می‌پردازند	میپردازند	#exact
mipardazim	می‌پردازیم	میپردازیم	#exact
mipichidam	میپیچیدم	می‌پیچیدم	#exact
mipoosad	میپوسد	#exact
miporsam	می‌پرسم	میپرسم	#exact
miporse	می‌پرسه	میپرسه	#exact
miraftam	میرفتم	می‌رفتم	#exact
miraftim	می‌رفتیم	میرفتیم	#exact
miraghse	میرقصه	#exact
miraghsidan	می‌رقصیدن	میرقصیدن	#exact
miram	میرم	#exact
miran	می‌رن	میرن	#exact
miravad	می‌رود	میرود	#exact
mirdamad	میرداماد	#exact
mire	میره	#exact
mirese	میرسه	#exact
miresi	می‌رسی	میرسی	#exact
miresid	میرسید	#exact
miri	میری	#exact
mirim	میریم	می‌ریم	#exact
mirin	میرین	#exact
misazan	می‌سازن	میسازن	#exact
misham	میشم	#exact
mishan	میشن	#exact
mishe	می‌شه	#exact
misheh	میشه	#exact
mishenavam	می‌شنوم	میشنوم	#exact
mishenidam	می‌شنیدم	میشنیدم	#exact
mishi	میشی	#exact
mishinam	می‌شینم	میشینم	#exact
mishnakhtamesh	میشناختمش	#exact
mishnakhtand	میشناختند	#exact
mishnavam	می‌شنوم	میشنوم	#exact
mishnavan	میشنون	#exact
mishnidish	میشنیدیش	#exact
mishod	میشد	#exact
mishodam	میشدم	#exact
miss	میس	#exact
mitarsan	می‌ترسن	میترسن	#exact
mitarse	می‌ترسه	میترسه	#exact
mitarsi	می‌ترسی	میترسی	#exact
mitavanad	میتواند	می‌تواند	#exact
miterekoonam	میترکونم	#exact
mitonam	می‌تونم	میتونم	#exact
mitonied	میتونید	#exact
mitoonam	می‌تونم	میتونم	#exact
mitoonan	می‌تونن	میتونن	#exact
mitoonand	میتونند	#exact
mitoone	میتونه	#exact
mitoonestam	می‌تونستم	میتونستم	#exact
mitooni	میتونی	#exact
mitoonim	می‌تونیم	میتونیم	#exact
mitoonin	می‌تونین	میتونین	#exact
mitune	میتونه	#exact
mitunim	می‌تونیم	میتونیم	#exact
mix	میکس	#exact
miyad	میاد	#exact
miyam	میام	#exact
miyoomad	میومد	#exact
mizad	میزد	#exact
mizadam	میزدم	#exact
mizam	میزم	#exact
mizanam	میزنم	#exact
mizanan	می‌زنن	میزنن	#exact
mizanand	می‌زنند	میزنند	#exact
mizane	میزان	می‌زنه	#exact
mizani	میزنی	میزانی	#exact
mizanim	می‌زنیم	میزنیم	#exact
mizanin	میزنین	#exact
mizaram	میزارم	#exact
mizari	میذاری	#exact
mizarin	میذارین	میزارین	#exact
mize	میز	#exact
mo'adabane	موادبانه	#exact
moazabam	معذبم	#exact
mobarak	مبارک	#exact
mobaraketo0n	مبارکتون	#exact
mobile	موبایل	#exact
mochakeram	مچکرم	#exact
modat	مدت	#exact
modati	مدتی	#exact
modatie	مدتیه	#exact
model	مدل	#exact
modele	مدل	#exact
moft	مفت	#exact
moghabele	مقابله	مقابل	#exact
moghe	موقع	#exact
mohabbataye	محبتای	#exact
mohamad	محمد	#exact
mohammad	محمد	#exact
mohandesi	مهندسی	#exact
mohasebato	محاسباتو	#exact
mohem	مهم	#exact
mohemat	مهمات	#exact
moheme	مهمه	مهم	#exact
mohemi	مهمی	#exact
mohemmat	مهمات	#exact
mohemtarin	مهمترین	#exact
mohkam	محکم	#exact
mohsen	محسن	#exact
moji	موجی	#exact
mojrian	مجریان	#exact
mojtaba	مجتبی	#exact
mokhalefam	مخالفم	#exact
mokhalefeshunam	مخالفشونم	#exact
mokhlesam	مخلصم	#exact
mokhlese	مخلص	#exact
mokhtalef	مختلف	#exact
mola	مولا	#exact
momken	ممکن	#exact
momkene	ممکن	ممکنه	#exact
mongol	منگل	#exact
monhaser	منحصر	#exact
montazer	منتظر	#exact
montazeram	منتظرم	#exact
montazere	منتظر	#exact
moon	مون	#exact
moond	موند	#exact
moonde	مونده	#exact
moose	موس	#exact
moozi	موذی	#exact
moqadas	مقدس	#exact
moqaddame	مقدمه	مقدم	#exact
moqava	مقوا	#exact
mor	مور	#exact
morakhas	مرخص	#exact
moratab	مرتب	#exact
morche	مورچه	#exact
mord	مرد	مورد	#exact
mordaad	مرداد	#exact
mordad	مرداد	#exact
mordam	مردم	#exact
morde	مرده	#exact
more	مور	مر	#exact
morede	مورد	#exact
moredo	موردو	#exact
mortazavi	مرتضوی	#exact
mosafer	مسافر	#exact
mosahebasham	مصاحبشم	#exact
mosahebee	مصاحبه	مصاحب	#exact
mosahebeh	مصاحبه	#exact
mosahebehaye	مصاحبه‌های	#exact
mosahebeye	مصاحبه‌ی	مصاحبه	#exact
mosallaman	مسلما	#exact
mosalman	مسلمان	#exact
mosbate	مثبت	#exact
moshakhasat	مشخصات	#exact
moshaver	مشاور	#exact
moshkel	مشکل	#exact
moshkelat	مشکلات	#exact
moshkeleh	مشکله	مشکل	#exact
moshkelesh	مشکلش	#exact
mosht	مشت	#exact
moshtarak	مشترک	#exact
mosicio	موزیکیو	#exact
mostanad	مستند	#exact
motade	معتاد	معتاده	#exact
motaghedam	معتقدم	#exact
motale'	مطالعه	#exact
motalee	مطالعه	#exact
motamaenam	مطمئنم	#exact
motasefane	متاسفانه	#exact
mote'ajeb	متعجب	#exact
moteasefane	متاسفانه	#exact
moteghaed	متقاعد	#exact
motenaferam	متنفرم	#exact
motevajeh	متوجه	#exact
motlaghe	مطلقه	مطلق	#exact
motmaen	مطمئن	#exact
motmaenam	مطمئنم	#exact
motmaenan	مطمئنا	#exact
motorola	موتورولا	motorola	#exact
motshaker	متشکر	#exact
movaafegham	موافقم	#exact
movafagh	موفق	#exact
movafagheyat	موفقیت	#exact
movafegh	موافق	#exact
movafeghatesho	موافقتشو	#exact
movazeb	مواظب	#exact
movazebe	مواظب	#exact
moz	موز	#exact
mozahem	مزاحم	#exact
mozakhraf	مزخرف	#exact
mozer	مضر	#exact
mozoe	موضوع	#exact
mp3	ام.پی.3	MP3	#exact
much	موچ	ماچ	#exact
muche	ماچ	ماچه	#exact
multi-core	مولتی-کر	#exact
music	موزیک	موسیقی	music	#exact
music	موزیک	#exact
mutli-core	موتلی-کر	چند هسته‌ای	multi-core	#exact
my	مای	می	my	#exact
myad	میاد	#exact
myaneye	میانه‌ی	#exact
na	نه	#exact
na're	نعره	نره	#exact
nabab	ناباب	#exact
nabash	نباش	#exact
nabashe	نباشه	#exact
nabastam	نبستم	#exact
nabavari	ناباوری	#exact
nabayad	نباید	#exact
nabeghe	نابغه	#exact
nabinam	نبینم	#exact
nabood	نبود	#exact
naboodam	نبودم	#exact
naboodim	نبودیم	#exact
nabud	نابود	نبود	#exact
nachar	ناچار	#exact
nadaarand	ندارند	#exact
nadad	نداد	#exact
nadadam	ندادم	#exact
nadadd	نداد	#exact
nadadi	ندادی	#exact
nadaram	ندارم	#exact
nadare	نداره	#exact
nadari	نداری	#exact
nadasht	نداشت	#exact
nadashtam	نداشتم	#exact
nadashtan	نداشتن	#exact
nadashte	نداشته	#exact
nadashti	نداشتی	#exact
nadid	ندید	#exact
nadidam	ندیدم	#exact
nadidand	ندیدند	#exact
nadide	ندیده	#exact
nadin	ندین	#exact
nadoone	ندونه	#exact
nadshte	نداشته	#exact
nafar	نفر	#exact
nafare	نفر	#exact
nafari	نفری	#exact
nafaro	نفرو	#exact
nafs	نفس	#exact
nagereft	نگرفت	#exact
nagereftam	نگرفتم	#exact
naghafel	ناغافل	#exact
naghes	ناقص	#exact
naghsh	نقش	#exact
naghshehaye	نقشه‌های	#exact
naghsho	نقشو	#exact
nagi	نگی	#exact
nagire	نگیره	نگیر	#exact
nagoftam	نگفتم	#exact
nagoftia	نگفتیا	#exact
nagonjid	نگنجید	#exact
nahaee	نهایی	نهائی	#exact
nahaii	نهایی	#exact
nahar	ناهار	#exact
nahayat	نهایت	#exact
nahofte	نهفته	#exact
nahv	نحو	#exact
nakard	نکرد	#exact
nakardam	نکردم	#exact
nakardan	نکردن	#exact
nakardd	نکرد	#exact
nakarde	نکرده	#exact
nakardeh	نکرده	#exact
nakardim	نکردیم	#exact
nakh	نخ	#exact
nakhaham	نخواهم	#exact
nakhordam	نخوردم	#exact
nakhorde	نخورده	نخورد	#exact
nakhore	نخوره	#exact
nakon	نکن	#exact
nakonam	نکنم	#exact
nakone	نکنه	#exact
nakoneh	نکنه	#exact
nakoni	نکنی	#exact
nakonid	نکنید	#exact
nakoon	نکون	#exact
namade	نماد	نمد	#exact
namak	نمک	#exact
namardie	نامردیه	#exact
name	نام	نامه	#exact
namidoonam	نمی‌دونم	نمیدونم	#exact
namikhore	نمی‌خوره	نمیخوره	#exact
namikonam	نمی‌کنم	نمیکنم	#exact
namishe	نمی‌شه	نمیشه	#exact
namizare	نمی‌ذاره	نمیذاره	#exact
nane	ننه	#exact
naneveshtam	ننوشتم	#exact
naoomade	نیومده	#exact
naraftam	نرفتم	#exact
narahat	ناراحت	#exact
narahati	ناراحتی	#exact
naraheteton	ناراحت‌تون	#exact
naram	نرم	#exact
narm	نرم	#exact
narmafzari	نرم‌افزاری	#exact
naro	نرو	#exact
nasb	نصب	#exact
nasbesh	نصبش	#exact
nashe	نشه	#exact
nashnase	نشناس	نشناسه	#exact
nashod	نشد	#exact
nashodam	نشدم	#exact
nashodam	نشدم	#exact
nashode	نشده	#exact
nashodim	نشدیم	#exact
nasibeshoon	نصیبشون	#exact
nasim	نسیم	#exact
nasl	نسل	#exact
natars	نترس	#exact
natarse	نترسه	#exact
natije	نتیجه	#exact
natoonestam	نتونستم	#exact
navaar	نوار	#exact
navazesh	نوازش	#exact
navazeshesho	نوازششو	#exact
nayad	نیاد	#exact
nazan	نزن	#exact
nazar	نظر	#exact
nazaram	نظرم	#exact
nazaram	نظرم	#exact
nazaramo	نظرمو	#exact
nazaratetoon	نظراتتون	نذراتتون	#exact
nazare	نظر	#exact
nazdik	نزدیک	#exact
nazdike	نزدیکه	نزدیک	#exact
nazli	نازلی	#exact
neda	ندا	#exact
nedaye	ندای	#exact
negah	نگاه	#exact
negaham	نگاهم	#exact
negahe	نگاه	#exact
negahesh	نگاهش	نگهش	#exact
negahi	نگاهی	#exact
negaran	نگران	#exact
negarane	نگران	#exact
negaranie	نگرانی	نگرانیه	#exact
negare	نگار	نگاره	#exact
negat	نگات	#exact
nejat	نجات	#exact
nekoi	نکوی	نکویی	#exact
nemi2nam	نمی‌تونم	#exact
nemiaram	نمیارم	#exact
nemiay	نمیای	#exact
nemibandan	نمی‌بندن	نمیبندن	#exact
nemibine	نمیبینه	#exact
nemibinim	نمی‌بینیم	#exact
nemidaadam	نمیدادم	#exact
nemidadan	نمیدادن	#exact
nemidam	نمی‌دم	نمیدم	#exact
nemide	نمی‌ده	نمیده	#exact
nemidi	نمیدی	#exact
nemidonam	نمی‌دونم	#exact
nemidone	نمیدونه	#exact
nemidonestam	نمیدونستم	#exact
nemidonid	نمی‌دونید	#exact
nemidoonam	نمی‌دونم	نمیدونم	#exact
nemidoonestam	نمیدونستم	#exact
nemidunam	نمیدونم	نمی‌دونم	#exact
nemidune	نمی‌دونه	نمیدونه	#exact
nemidunestam	نمی‌دونستم	نمیدونستم	#exact
nemifahmam	نمی‌فهمم	نمیفهمم	#exact
nemigam	نمی‌گم	#exact
nemigardad	نمیگردد	#exact
nemigiram	نمی‌گیرم	نمیگیرم	#exact
nemigonji	نمی‌گنجی	نمیگنجی	#exact
nemigozarad	نمی‌گذارد	#exact
nemigozasht	نمی‌گذشت	نمیگذشت	نمی‌گذاشت	نمی‌گذشت	#exact
nemigzare	نمی‌گذره	نمیگذره	#exact
nemijavabi	نمیجوابی	#exact
nemikardam	نمیکردم	نمی‌کردم	#exact
nemikhone	نمی‌خونه	نمیخونه	#exact
nemikhoreh	نمی‌خوره	نمیخوره	#exact
nemikonam	نمی‌کنم	نمیکنم	#exact
nemikone	نمی‌کنه	#exact
nemikoneh	نمی‌کنه	#exact
nemikoni	نمی‌کنی	نمیکنی	#exact
nemimoone	نمی‌مونه	نمیمونه	#exact
nemire	نمیره	#exact
nemirese	نمیرسه	#exact
nemirese	نمیرسه	#exact
nemishe	نمی‌شه	نمیشه	#exact
nemisheh	نمیشه	#exact
nemishi	نمیشی	#exact
nemishin	نمیشین	#exact
nemishnave	نمیشنوه	#exact
nemishod	نمی‌شد	نمیشد	#exact
nemitarsam	نمی‌ترسم	نمیترسم	#exact
nemitone	نمیتونه	#exact
nemitonid	نمیتونید	#exact
nemitoonam	نمیتونم	#exact
nemitoone	نمیتونه	#exact
nemitoonestam	نمیتونستم	#exact
nemitunam	نمیتونم	نمی‌تونم	#exact
nemiyad	نمیاد	#exact
nemizadam	نمی‌زدم	نمیزدم	#exact
nemizanam	نمی‌زنم	نمیزنم	#exact
nemizare	نمیذاره	نمیزاره	#exact
nesbat	نسبت	#exact
nesf	نصف	#exact
nesfi	نصفی	#exact
neshast	نشست	#exact
neshastan	نشستن	#exact
neshaste	نشسته	#exact
neshestam	نشستم	#exact
nesheste	نشسته	#exact
neshon	نشون	#exact
neshonie	نشونه‌ای	نشونه‌یی	#exact
neshoon	نشون	#exact
neshoonei	نشونه‌ای	#exact
neshooneye	نشونه‌ی	نشانه‌ی	#exact
net	نت	شبکه	net	#exact
network	نتورک	شبکه	network	#exact
neveshtam	نوشتم	#exact
neveshtan	نوشتن	#exact
neveshtand	نوشتند	#exact
neveshte	نوشته	#exact
neveshteh	نوشته	#exact
neveshteha	نوشته‌ها	نوشتها	#exact
neveshtehaaye	نوشته‌های	#exact
neveshteye	نوشته‌ی	#exact
nevisande	نویسنده	#exact
new	نیو	جدید	new	#exact
next	نکست	بعد	next	#exact
niaz	نیاز	#exact
nice	نایس	دلپسند	nice	#exact
night	نایت	شب	night	#exact
nim	نیم	#exact
nima	نیما	#exact
nimam	نیمام	#exact
nina	نینا	#exact
niroogah	نیروگاه	#exact
nis	نیس	#exact
nist	نیست	#exact
nistaa	نیستا	#exact
nistam	نیستم	#exact
nistama	نیستما	#exact
nistand	نیستند	#exact
nisti	نیستی	#exact
nistid	نیستید	#exact
nistim	نیستیم	#exact
nisty	نیستی	#exact
niyayesh	نیایش	#exact
no	نو	#exact
nobel	نوبل	#exact
noboogh	نبوغ	#exact
noe	نوع	#exact
nokaretam	نوکرتم	#exact
nokhod	نخود	#exact
nokia	نوکیا	nokia	#exact
nomre	نمره	#exact
noon	نون	#exact
noone	نون	نونه	#exact
noono	نون‌و	#exact
noorani	نورانی	#exact
november	نوامبر	november	#exact
now	نو	الان	now	#exact
ntesab	انتصاب	انتساب	#exact
nyazhaye	نیازهای	#exact
o0n	اون	#exact
oct	اکتبر	#exact
october	اکتبر	october	#exact
of	آو	of	#exact
office	آفیس	office	#exact
oftadam	افتادم	#exact
oftadast	افتادست	#exact
oftade	افتاده	افتاد	#exact
oftadeh	افتاده	#exact
oftadeid	افتاده‌اید	#exact
oh	اوه	#exact
ojagh	اجاق	#exact
oje	اوج	#exact
ok	اوکی	باشه	ok	#exact
omad	اومد	#exact
omadd	اومد	#exact
omade	اومده	#exact
omadeh	اومده	#exact
omid	امید	#exact
omidvaram	امیدوارم	#exact
omidvram	امیدوارم	#exact
omidwarem	امیدورام	#exact
omisho	امیشه	#exact
omoomi	عمومی	#exact
omram	عمرم	#exact
omran	عمران	عمرا	#exact
omre	عمر	#exact
on	اون	آن	#exact
onae	اونایی	اونا	#exact
onaei	اونایی	#exact
onam	اونم	#exact
oncall	آنکال	#exact
one	اونه	#exact
oni	اونی	#exact
onja	اونجا	#exact
onjast	آنجاست	#exact
online	آنلاین	برخط	online	#exact
onmoghe	اون‌موقع	اونموقه	#exact
onshaba	اون‌شبا	اونشبا	#exact
ontoori	اونطوری	#exact
onvan	عنوان	#exact
onvane	عنوان	عنوانه	#exact
oo	اوو	#exact
oo	او	اوو	#exact
oomad	اومد	#exact
oomadam	اومدم	#exact
oomadan	اومدن	#exact
oomade	اومده	#exact
oomadeh	اومده	#exact
oomadim	اومدیم	#exact
oomadin	اومدین	#exact
oomadio	اومدیو	#exact
oomado	اومدو	#exact
oon	اون	#exact
oona	اونا	#exact
oonam	اونم	#exact
oonhaa	اونها	#exact
ooni	اونی	#exact
oonja	اونجا	#exact
oonjaa	اونجا	#exact
oono	اونو	#exact
oontaraf	اونطرف	#exact
oonvar	اونور	#exact
ooonam	اونم	#exact
open	اوپن	باز	Open	#exact
optimization	اپتیمایزیشن	Optimization	#exact
or	اور	یا	or	#exact
org	ارگ	#exact
organo	ارگانو	#exact
oskol	اوسکل	#exact
osoolan	اصولا	#exact
osoolgara	اصولگرا	#exact
ostad	استاد	#exact
ostadam	استادم	#exact
ostade	استاد	#exact
otaagham	اتاقم	اطاقم	#exact
otaghamo	اتاقمو	#exact
otaghim	اتاقیم	#exact
otaghimo	اتاقیمو	#exact
otoboos	اتوبوس	#exact
otobosa	اتوبوسا	#exact
otobose	اتوبوس	#exact
otobus	اتوبوس	#exact
oumad	اومد	#exact
oun	اون	#exact
ounam	اونم	#exact
ounvaght	اونوقت	#exact
ovordam	اوردم	#exact
ovordi	آوردی	#exact
oza	اوضا	اوضاع	#exact
ozvi	عضوی	#exact
pa	پا	#exact
paadeshahe	پادشاه	#exact
paak	پاک	#exact
padideye	پدیده‌ی	پدیده	#exact
paeen	پایین	پائین	#exact
pagamo	پیجمو	#exact
page	پیج	صفجه	Page	#exact
pagesh	پیجش	#exact
pak	پاک	پک	#exact
pakestani	پاکستانی	#exact
pakhsh	پخش	#exact
paki	پاکی	#exact
palang	پلنگ	#exact
palidi	پلیدی	#exact
pam	پام	#exact
panjereham	پنجره‌هام	#exact
papa	پاپا	#exact
parallel	پارالل	موازی	parallel	#exact
parasite	پارازیت	#exact
parastoo	پرستو	#exact
pardaziye	پردازی	پردازیه	#exact
parde	پرده	#exact
pardeye	پرده‌ی	پرده	#exact
pare	پاره	پر	#exact
parishab	پریشب	#exact
parishan	پریشان	#exact
parishooni	پریشونی	#exact
park	پارک	#exact
parsal	پارسال	#exact
parsal	پارسال	#exact
part	پرت	#exact
party	پارتی	#exact
parvaz	پرواز	#exact
parya	پریا	#exact
pas	پس	#exact
pasandet	پسندت	#exact
pasesh	پسش	#exact
pashe	پشه	#exact
pashimoon	پشیمون	#exact
patoogh	پاتوق	#exact
payane	پایان	#exact
payani	پایانی	#exact
paye	پایه	پای	#exact
payeam	پایه‌ام	پاییم	#exact
payeh	پایه	پای	#exact
paytakhte	پایتخت	پایتخته	#exact
paze	پز	#exact
pegham	پیغام	#exact
peida	پیدا	#exact
penhoon	پنهون	#exact
performance	پرفورمنس	کارایی	performance	#exact
permanent	پرمننت	ماندگار	permanent	#exact
persian	پرشین	#exact
pert	پرت	#exact
pesar	پسر	#exact
pesare	پسر	#exact
pesaroonaro	پسرونرو	#exact
peyda	پیدا	#exact
peydash	پیداش	#exact
peydat	پیدات	#exact
peye	پی	#exact
peygham	پیغام	#exact
peyma	پیما	#exact
peymooneh	پیمونه	#exact
pezeshki	پزشکی	#exact
phone	فن	تلفن	phone	#exact
photo	فوتو	عکس	photo	#exact
piade	پیاده	#exact
picasa	پیکاسا	#exact
pichidam	پیچیدم	#exact
piish	پییش	#exact
ping	پینگ	#exact
pir	پیر	#exact
piremarde	پیرمرد	#exact
pirmard	پیرمرد	#exact
piroz	پیروز	#exact
pish	پیش	#exact
pisham	پیشم	#exact
pishe	پیش	#exact
pishemoon	پیشمون	#exact
pishet	پیشت	#exact
pishnahadati	پیشنهاداتی	#exact
pishraft	پیشرفت	#exact
pishrafte	پیشرفته	پیشرفت	#exact
piyade	پیاده	#exact
please	پلیز	لطفا	please	#exact
pm	پی‌.ام	pm	#exact
pofak	پفک	#exact
pofioz	پفیوز	#exact
pofyooza	پفیوزا	#exact
pola	پولا	#exact
pole	پول	#exact
polo	پلو	#exact
polopaze	پلوپز	#exact
pong	پنگ	#exact
pool	پول	#exact
poole	پول	#exact
poolesho	پولشو	#exact
poostam	پوستم	پستم	#exact
pooste	پوست	پوسته	#exact
por	پر	#exact
poraz	پراز	#exact
pore	پوره	#exact
porn	پرن	porn	#exact
porojeye	پروژه‌ی	#exact
portable	پرتابل	قابل حمل	portable	#exact
poshte	پشت	#exact
poshtesh	پشتش	#exact
poshtkar	پشتکار	#exact
post	پست	#exact
postam	پوستم	#exact
poste	پست	#exact
posteshoon	پستشون	#exact
postet	پستت	پوستت	#exact
postetoon	پستتون	#exact
power	پاور	قدرت	power	#exact
print	پرینت	چاپ	print	#exact
prirozesh	پریروزش	#exact
privacy	پریوکی	پرایوسی	#exact
private	پرایوت	خصوصی	private	#exact
pro	پرو	#exact
professor	پروفسور	#exact
profile	پروفایل	profile	#exact
proje	پروژه	#exact
project	پروجکت	پروژه	project	#exact
projectam	پروجکتم	#exact
qabli	قبلی	#exact
qesmat	قسمت	#exact
quiz	کویز	#exact
ra	را	#exact
raaham	راهم	#exact
raahnamaa	راهنما	#exact
raame	رام	رامه	#exact
raazist	رازیست	#exact
rabtesho	ربطشو	#exact
rad	رد	رعد	#exact
radio	رادیو	#exact
radioactive	رادیواکتیو	#exact
raeesam	رئیسم	#exact
raeesame	رئیسمه	#exact
rafigh	رفیق	#exact
raft	رفت	#exact
raft	رفت	#exact
raftam	رفتم	#exact
raftan	رفتن	#exact
raftane	رفتن	#exact
raftanesho	رفتنشو	#exact
raftaresho	رفتارشو	#exact
rafte	رفته	#exact
rafti	رفتی	#exact
raftid	رفتید	#exact
raftim	رفتیم	#exact
rafty	رفتی	#exact
raghm	رغم	#exact
raghs	رقص	#exact
rah	راه	ره	#exact
rahat	راحت	#exact
rahattare	راحتتره	#exact
rahe	راه	#exact
rahi	راهی	رهی	#exact
rahim	رحیم	#exact
rahimi	رحیمی	#exact
rahmatollahe	رحمت‌الاهه	#exact
rahnamaii	راهنمایی	#exact
rahnamaye	راهنمای	راهنمایه	#exact
rahnamee	راهنمایی	#exact
raje	راجع	#exact
raje	راجع	#exact
rajebe	راجع به	راجبه	#exact
ranande	راننده	#exact
ranandehe	راننده	#exact
range	رنگ	رنج	برد	range	#exact
ranginkamane	رنگین‌کمان	رنگینکمان	#exact
raoof	رئوف	#exact
rap	رپ	#exact
rar	رر	rar	#exact
rashti	رشتی	#exact
rasman	رسما	#exact
rast	راست	#exact
rastaye	راستای	#exact
rastesh	راستش	#exact
rastesho	راستشو	#exact
rasti	راستی	#exact
rasty	راستی	#exact
ravabete	روابط	#exact
razist	رازیست	#exact
real	رئال	ریل	واقعی	real	#exact
refigh	رفیق	#exact
refigham	رفیقم	رفیقام	#exact
refighamam	رفیقمم	#exact
refighame	رفیقمه	#exact
refighamo	رفیقمو	#exact
refighet	رفیقت	#exact
register	رجیستر	ثبت‌نام	register	#exact
report	ریپرت	گزارش	report	#exact
reporte	ریپورت	#exact
resad	رسد	#exact
research	ریسرچ	پژوهش	research	#exact
reshte	رشته	#exact
reshteye	رشته‌ی	رشته	#exact
resid	رسید	#exact
residam	رسیدم	#exact
residan	رسیدن	#exact
residim	رسیدیم	#exact
reza	رضا	#exact
riazi	ریاضی	#exact
riazye	ریاضی	ریاضی یه	#exact
ridam	ریدم	#exact
rikhtam	ریختم	#exact
rikhtane	ریختن	#exact
rikhtim	ریختیم	#exact
rings	رینگز	#exact
ringtone	رینگتنه	rینگتن	#exact
rish	ریش	#exact
risheie	ریشه‌ی	ریشه	#exact
riske	ریسک	ریسکه	#exact
ritm	ریتم	#exact
rize	ریزه	ریز	#exact
ro	رو	#exact
rob	رب	#exact
robert	رابرت	ربرت	#exact
romo	رومو	رمو	#exact
ronaldo	رونالدو	#exact
roo	رو	#exact
rooberoo	روبرو	#exact
rooberoom	روبروم	#exact
rooh	روح	#exact
room	روم	اتاق	room	#exact
roosh	روش	#exact
rooye	روی	#exact
rooz	روز	#exact
rooza	روزا	#exact
roozaa	روزا	#exact
roozam	روزم	روزام	#exact
roozaye	روزای	#exact
roozayee	روزایه	روزایی	#exact
rooze	روز	روزه	#exact
roozesham	روزشم	#exact
roozhaaye	روزهای	#exact
roozi	روزی	#exact
roshan	روشن	#exact
roshane	روشنه	#exact
roshani	روشنی	#exact
rotbe	رتبه	#exact
rou	رو	#exact
rouz	روز	#exact
royahamo	رویاهامو	#exact
roye	روی	#exact
roz	روز	رز	#exact
roza	روزا	رزا	#exact
rozbeh	روزبه	#exact
rozhaye	روزهای	#exact
rozname	روزنامه	#exact
ru	رو	روی	#exact
ruhi	روحی	#exact
ruye	روی	#exact
ruzi	روزی	#exact
sa@	ساعت	#exact
saalam	سلام	#exact
saat	ساعت	#exact
sabado	سبدو	سبد	#exact
sabke	سبک	#exact
sabkesh	سبکش	#exact
sabr	صبر	#exact
sad	صد	#exact
sade	ساده	#exact
sadegh	صادق	#exact
sadeq	صادق	#exact
saeat	ساعت	#exact
saeed	سعید	#exact
safar	سفر	#exact
safarian	صفریان	صفاریان	#exact
safe	صاف	سیف	مطمئن	safe	#exact
safheye	صفحه‌ی	صفحه	#exact
sag	سگ	#exact
sage	سگه	سگ	#exact
sahar	سحر	صحر	#exact
sahario	سحری‌و	سحری	#exact
sahm	سهم	#exact
sahme	سهم	سهمه	#exact
sahne	صحنه	#exact
sahneye	صحنه‌ی	صحنه	#exact
saieash	سعیش	#exact
saite	سایت	#exact
saket	ساکت	#exact
sakht	سخت	ساخت	#exact
sakhtane	ساختن	#exact
sakhte	ساخته	سخته	#exact
sakhtemoon	ساختمون	#exact
sakhtemoone	ساختمونه	سختمونه	#exact
sakhttarin	سخت‌ترین	#exact
sal	سال	#exact
salam	سلام	#exact
salamat	سلامت	#exact
salamati	سلامتی	#exact
salame	سلام	#exact
sale	سال	ساله	#exact
salegi	سالگی	#exact
saleh	ساله	#exact
salem	سالم	#exact
saleme	سالم	سالمه	#exact
salet	سالت	#exact
saligheye	سلیقه‌ی	سلیقه	#exact
sallam	سلام	#exact
sama	سما	صما	#exact
samsung	سامسونگ	#exact
samte	سمت	#exact
san'at	صنعت	#exact
san'athaye	صنعت‌های	#exact
sandwich	ساندویچ	sandwich	#exact
sanginiye	سنگینیه	سنگینی	#exact
sanie	ثانیه	ثانی	#exact
sanyo	سانیو	sanyo	#exact
saqfo	سقف‌و	سقف	#exact
sar	سر	#exact
saraki	سرکی	#exact
saram	سرم	#exact
saramo	سرمو	#exact
sarapa	سراپا	#exact
sarasari	سراسری	#exact
sarbaze	سرباز	#exact
sardard	سردرد	#exact
sare	سر	#exact
saresh	سرش	#exact
sareshon	سرشون	#exact
sareshoon	سرشون	#exact
saret	سرت	#exact
sareton	سرتون	#exact
saretoono	سرتونو	#exact
sari	سری	سریع	#exact
sarih	صریح	#exact
sarma	سرما	#exact
sarmaye	سرمایه	#exact
sarmayegozari	سرمایه‌گذاری	#exact
sarnevesht	سرنوشت	#exact
saro	سرو	#exact
sarvare	سرور	#exact
sarvaremoon	سرورمون	#exact
sarvari	سروری	#exact
sarvenaz	سروناز	#exact
sarvy	سروی	#exact
savaresh	سوارش	#exact
say	سعی	#exact
sayamo	سعیمو	سایمو	#exact
sayatam	سایتم	#exact
saze	سازه	ساز	#exact
se	سه	#exact
searchamo	سرچمو	#exact
security	سکیوریتی	امنیت	security	#exact
seda	صدا	#exact
sedaash	صداش	#exact
sedaaye	صدای	#exact
sedahaye	صداهای	#exact
sedam	صدام	#exact
sedamo	صدامو	#exact
sedash	صداش	#exact
sedasho	صداشو	#exact
sedato	صداتو	#exact
sedaye	صدای	#exact
sedayee	صدایی	#exact
sefareshe	سفارش	#exact
sei	سه‌ای	#exact
seire	سیر	#exact
send	سند	ارسال	send	#exact
senin	سنین	#exact
sep	سپ	سپتامبر	sep	#exact
sepanlou	سپنلو	سپانلو	#exact
september	سپتامبر	semtember	#exact
serat	صراط	#exact
seri	سری	#exact
serooz	سه‌روز	#exact
servatmandtarin	ثروتمندترین	#exact
server	سرور	server	#exact
service	سرویس	service	#exact
seshanbe	سه‌شنبه	#exact
session	سشن	جلسه	session	#exact
set	ست	مجموعه	set	#exact
setareh	ستاره	#exact
sevomemon	سوممون	#exact
sewed	سوئد	#exact
sex	سکس	رابطه‌ی جنسی	sex	#exact
sexi	سکی	Sexy	#exact
shaadi	شادی	#exact
shab	شب	#exact
shabakehaie	شبکه‌های	شبک‌های	#exact
shabaye	شبای	#exact
shabe	شب	شبه	#exact
shabhaye	شب‌های	#exact
shabi	شبی	#exact
shabihe	شبیه	#exact
shad	شاد	#exact
shadi	شادی	#exact
shadid	شدید	#exact
shadidan	شدیدا	#exact
shadimoon	شادیمون	#exact
shadmehr	شادمهر	#exact
shadmehr	شادمهر	#exact
shado	شاد	شادو	#exact
shadtar	شادتر	#exact
shahr	شهر	#exact
shahre	شهر	#exact
shahreshon	شهرشون	#exact
shahrzad	شهرزاد	#exact
shahrzado	شهرزادو	#exact
shahzadeh	شاهزاده	#exact
shak	شک	#exact
shakhsiatesh	شخصیتش	#exact
shakhsiatesham	شخسیتشم	#exact
shakhsiatesham	شخصیتشم	#exact
shakhsyat	شخصیت	#exact
shakhsyati	شخصیتی	#exact
sham	شم	#exact
sham'ha	شمع‌ها	#exact
shamo	شمو	شمع	شمع‌و	#exact
shan	شان	شن	#exact
shanbe	شنبه	#exact
shanbeh	شنبه	#exact
shans	شانس	#exact
shansam	شانسم	#exact
shanse	شانس	#exact
shansiroo	شانسی‌رو	#exact
sharghi	شرقی	#exact
sharhe	شرح	شرحه	#exact
sharik	شریک	#exact
sharm	شرم	#exact
sharmandam	شرمندم	#exact
sharmande	شرمنده	#exact
sharmandeh	شرمنده	#exact
sharto	شرطو	شرط	#exact
shayad	شاید	#exact
shayadm	شایدم	#exact
she	شه	#exact
shedate	شدت	#exact
sheer	شعر	#exact
shekan	شکن	#exact
shekaste	شکسته	#exact
shekasteh	شکسته	#exact
shekl	شکل	#exact
shekle	شکل	#exact
shemord	شمرد	#exact
shenakhtanam	شناختنم	#exact
shenava	شنوا	#exact
shenid	شنید	صحنید	#exact
shenidam	شنیدم	#exact
shenidamesh	شنیدمش	#exact
shere	شر	شعر	#exact
sheresh	شعرش	شرش	#exact
sherkat	شرکت	#exact
sherkataye	شرکتای	#exact
sherkate	شرکت	#exact
sherkatesh	شرکتش	#exact
sherkati	شرکتی	#exact
shero	شرو	شعرو	#exact
shid	شید	#exact
shikami	شیکمی	#exact
shila	شیلا	#exact
shim	شیم	#exact
shima	شیما	#exact
shishe	شیشه	#exact
sho'oor	شعور	#exact
shod	شد	#exact
shodam	شدم	#exact
shodan	شدن	#exact
shodane	شدن	شدنه	#exact
shode	شده	#exact
shodeh	شده	#exact
shodi	شدی	#exact
shodid	شدید	#exact
shodim	شدیم	#exact
shohadaye	شهدای	#exact
shohar	شوهر	#exact
shokret	شکرت	#exact
sholughe	شلوغ	#exact
shom	شوم	#exact
shoma	شما	#exact
shomaa	شما	#exact
shomaha	شماها	#exact
shomal	شمال	#exact
shomam	شمام	#exact
shomare	شماره	#exact
shomareh	شماره	#exact
shomareye	شماره‌ی	شماره	#exact
shomari	شماری	#exact
shomaro	شمارو	#exact
shood	شد	شود	#exact
shookh	شوخ	#exact
shooloogh	شلوغ	#exact
shooroo	شورو	شروع	#exact
shoro	شروع	#exact
shoroo	شروع	#exact
shorooe	شروع	#exact
shotori	شتری	#exact
shouhar	شوهر	#exact
shuno	شونو	#exact
siah	سیاه	سیه	#exact
siavash	سیاوش	#exact
sibilam	سیبیلام	سیبیلم	#exact
sibzamini	سیب‌زمینی	#exact
sigh	سیق	#exact
sign	ساین	امضا	sign	#exact
silent	سایلنت	#exact
silver	سیلور	#exact
siman	سیمان	#exact
sina	سینا	#exact
single	سینگل	مجرد	single	#exact
singlesh	سینگلش	#exact
site	سایت	#exact
sitesh	سایتش	#exact
siteshe	سایتش	#exact
sitetam	سایتتم	#exact
sitetono	سایتتونو	#exact
sitt	سیت	سایت	#exact
size	سایز	اندازه	size	#exact
sms	اس.ام.اس	پیامک	SMS	#exact
sms	اس.ام.اس	پیام کوتاه	sms	#exact
smso	اس.ام.اس و	#exact
so	سو	پس	so	#exact
soal	سوال	#exact
soale	سوال	#exact
sob	صب	صبح	#exact
sobat	ثبات	#exact
sobh	صبح	#exact
sobhgahi	صبحگاهی	#exact
sohbat	صحبت	#exact
sokhanranihaye	سخنرانیهای	#exact
sokoote	سکوت	#exact
solh	صلح	#exact
solombe	سلمبه	#exact
sony	سونی	sony	#exact
sooeestefade	سوء استفاده	#exact
soog	سوگ	#exact
sooie	سوی	سوء	#exact
soorat	صورت	#exact
soorate	صورت	#exact
soorati	صورتی	#exact
soot	سوت	#exact
sooti	سوتی	صوتی	#exact
sooye	سوی	#exact
soraatesh	سرعتش	#exact
sorat	صورت	سرعت	#exact
soratesh	صورتش	#exact
sorfeham	سرفه‌هام	#exact
sorry	ساری	معذرت	sorry	#exact
sosan	سوسن	#exact
sosol	سوسول	#exact
sost	سست	#exact
star	استار	ستاره	*	Star	#exact
statamo	استیتمو	#exact
steres	استرس	#exact
sunday	ساندی	شنبه	sunday	#exact
super	سوپر	#exact
susan	سوسن	#exact
suzo	سوزو	#exact
ta	تا	#exact
ta'ajob	تعجب	#exact
ta'ajobaye	تعجبای	#exact
ta'siri	تاثیری	#exact
taa	تا	تعا	#exact
taabe	تابع	تاب	تب	#exact
taabestoon	تابستون	#exact
taaskabab	تاسکباب	#exact
tabarok	تبرک	#exact
tabdil	تبدیل	#exact
tabeie	طبیعی	#exact
tabrik	تبریک	#exact
tafaole	تفال	#exact
tafavot	تفاوت	#exact
tafavote	تفاوت	#exact
taghdir	تقدیر	#exact
taghir	تغییر	#exact
taghriban	تقریبا	#exact
taghsire	تقصیر	#exact
taghviate	تقویت	#exact
tah	ته	#exact
tahala	تاحالا	#exact
tahammole	تحمل	#exact
tahamol	تحمل	#exact
tahavol	تحول	#exact
tahesh	تهش	#exact
tahiye	تهیه	#exact
tahvil	تحویل	#exact
tahvile	تحویل	تحویله	#exact
tajavoz	تجاوز	#exact
tajrobeye	تجربه‌ی	#exact
tak	تک	#exact
takeshon	تکشون	#exact
takht	تخت	#exact
takhtam	تختم	#exact
takhte	تخته	تخت	#exact
takir	تکبیر	#exact
tako	تکو	تاکو	#exact
taksia	تاکسیا	#exact
talab	طلب	تالاب	#exact
talafish	تلافیش	#exact
talashhaye	تلاش‌های	#exact
tamaam	تمام	#exact
tamaame	تمام	#exact
tamam	تمام	#exact
tamame	تمام	#exact
tamarkoz	تمرکز	#exact
tamarkoze	تمرکز	#exact
tamasha	تماشا	#exact
tamoom	تموم	#exact
tamoome	تمومه	#exact
tamoomesh	تمومش	#exact
tamum	تموم	#exact
tang	تنگ	#exact
tanha	تنها	#exact
tanhaa	تنها	#exact
tanhaeest	تنهاییست	#exact
tanhaii	تنهایی	#exact
tanham	تنهام	#exact
tanham	تنهام	#exact
tanhayee	تنهایی	تنهائی	#exact
tanhayim	تنهاییم	#exact
tapaleye	تاپاله‌ی	#exact
tapanche	تپانچه	#exact
tapash	طپش	تپش	#exact
tapesh	طپش	#exact
tar	تر	#exact
taraanash	ترانش	#exact
taraaneh	ترانه	#exact
taraanehaaye	ترانه‌های	#exact
taraf	طرف	#exact
tarafa	طرفا	#exact
tarafast	طرفاست	#exact
tarafdaaresh	طرفدارش	#exact
tarafdare	طرفدار	#exact
tarafdareh	طرفدار	طرفداره	#exact
tarafe	طرف	#exact
tarafesh	طرفش	#exact
tarafeshoono	طرفشونو	#exact
tarafo	طرفو	#exact
tarahie	طراحی	طراحیه	#exact
taran	ترن	#exact
taranash	ترانش	#exact
taranehash	ترنه‌هاش	#exact
taranehye	ترانه‌ی	#exact
taraneye	ترانه‌ی	#exact
tare	تره	تاره	#exact
tarfdareh	طرفدار	طرفداره	#exact
tarif	تعریف	#exact
tarikh	تاریخ	#exact
tariki	تاریکی	#exact
tarin	ترین	#exact
tars	ترس	#exact
tasavi	تساوی	#exact
tasavir	تصاویر	#exact
tashakor	تشکر	#exact
tashkhis	تشخیص	#exact
tashoono	تشونو	تاشونو	#exact
tashrif	تشریف	#exact
tasiir	تاثیر	#exact
taskhire	تسخیر	#exact
taskin	تسکین	#exact
tasliat	تسلیت	#exact
tasmim	تصمیم	#exact
tasmimate	تصمیمات	#exact
tasviire	تصویر	#exact
tavajoh	توجه	#exact
tavakolet	توکلت	#exact
tavallode	تولد	#exact
tavalode	تولد	#exact
tavasote	توسط	#exact
tayin	تعیین	#exact
tazakoretoon	تذکرتون	#exact
taze	تازه	#exact
tazeh	تازه	#exact
tazehgiha	تازه‌گیها	#exact
tazmin	تضمین	#exact
techno	تکنو	#exact
tehran	تهران	#exact
tei	طی	#exact
tejari	تجاری	#exact
tekrar	تکرار	#exact
telephone	تلفن	#exact
teleshoon	تلشون	#exact
teletam	تلتم	#exact
tey	طی	#exact
the	ده	#exact
thread	ترد	نخ	thread	#exact
thursday	ترزدی	پنج‌شنبه	#exact
tigh	تیغ	#exact
tike	تیک	تیکه	#exact
tina	تینا	#exact
tiq	تیغ	#exact
titletam	تایتلتم	#exact
tnx	تنکس	متشکر	tnx	#exact
to	تو	#exact
toam	توام	#exact
todo	تودو	لیست انجام کار	todo	#exact
toefl	تافل	TOEFL	#exact
toei	توئی	#exact
tofang	تفنگ	#exact
tohin	توهین	#exact
toman	تومان	تومن	#exact
tomani	تومانی	تومنی	#exact
tone	تن	#exact
tonestid	تونستید	#exact
too	تو	#exact
toode	توده	#exact
tool	طول	تول	ابزار	tool	#exact
toonestam	تونستم	#exact
toosh	توش	#exact
tooye	توی	#exact
top	تاپ	top	#exact
topic	تاپیک	موضوع	topic	#exact
tor	طور	#exact
tore	طور	#exact
tori	طوری	#exact
tosh	توش	#exact
toshak	تشک	#exact
tosifate	توصیفات	#exact
tou	تو	#exact
touye	توی	#exact
toye	توی	#exact
tozih	توضیح	#exact
tozihate	توضیحات	#exact
track	ترک	قسمت	track	#exact
tu	تو	#exact
turkiye	ترکیه	#exact
tv	تی.وی	تلویزیون	TV	#exact
twin	توین	#exact
type	تایپ	#exact
uk	یو.کی	انگلیس	uk	#exact
umad	اومد	#exact
umade	اومده	#exact
un	اون	#exact
una	اونا	#exact
unja	اونجا	#exact
unjai	اونجایی	#exact
untor	اونطور	#exact
unyekio	اون‌یکیو	#exact
up	آپ	بالا	up	#exact
upload	آپلود	ارسال فایل	upload	#exact
us	یو.اس	US	#exact
usa	یو.اس.ای	آمریکا	USA	#exact
user	یوزر	کاربر	استفاده‌ کننده	#exact
va	و	#exact
vaase	واسه	#exact
vagar	وگر	#exact
vagarna	وگرنه	#exact
vaghe	واقع	#exact
vaghean	واقعا	واقعن	#exact
vaghean	واقعا	#exact
vaghen	واقعا	#exact
vaght	وقت	#exact
vaght	وقت	#exact
vaghtayee	وقتایی	#exact
vaghte	وقت	#exact
vaghti	وقتی	#exact
vaghtii	وقتی	#exact
vaghty	وقتی	#exact
vagty	وقتی	#exact
vaie	وای	#exact
vajebe	واجبه	واجب	#exact
val	ول	#exact
vala'	ولع	والا	#exact
vali	ولی	#exact
valiasr	ولیعصر	#exact
valimishe	ولیمیشه	#exact
valy	ولی	#exact
van	وان	ون	#exact
vaqt	وقت	#exact
var	ور	#exact
varam	وارم	ورم	#exact
vared	وارد	#exact
varedan	واردن	#exact
varede	وارد	#exact
vasam	واسم	#exact
vasash	واسش	#exact
vasat	واست	#exact
vasate	وسط	#exact
vasatesh	وسطش	#exact
vasatun	واستون	#exact
vasayel	وسایل	وسائل	#exact
vase	واسه	#exact
vasetoon	واستون	#exact
vaseye	واسه‌ی	واسه	#exact
vasl	وصل	#exact
vay	وای	#exact
vaziat	وضعیت	#exact
vaziate	وضعیت	#exact
vazifamoo	وظیفمو	#exact
vel	ول	#exact
vere	ور	وره	#exact
version	ورژن	نسخه	version	#exact
versione	ورژن	نسخه‌ی	version	#exact
very	وری	خیلی	very	#exact
vezarat	وزارت	#exact
vezarate	وزارت	#exact
video	ویدئو	#exact
videohaye	ویدئوهای	#exact
videohaye	ویدئوهای	#exact
videoiye	ویدئوی	#exact
videoye	ویدئوی	ویدیوی	#exact
view	ویو	دید	view	#exact
virgin	ویرجین	باکره	virgin	#exact
visit	ویزیت	#exact
visitet	ویزیتت	#exact
vocal	وکال	شفاهی	vocal	#exact
vom	وم	#exact
vorod	ورود	#exact
wayy	وای	وی	#exact
web	وب	web	#exact
weblog	وبلاگ	یادداشت‌های شخصی	weblog	#exact
weblogam	وبلاگم	#exact
webloge	وبلاگ	#exact
webloget	وبلاگت	#exact
weblogetoono	وبلگتونو	#exact
wednesday	ونزدی	چهارشنبه	wednesday	#exact
what	وات	چی	What	#exact
who	وهو	#exact
wiki	ویکی	#exact
wink	وینک	چشمک	wink	#exact
wire	وایر	سیم	wire	#exact
witexo	وایتکس	#exact
with	ویت	با	with	#exact
word	ورد	کلمه	word	#exact
www	دبلیو.دبلیو.دبلیو	www	#exact
x	ایکس	فلان	x	#exact
ya	یا	#exact
yaad	یاد	#exact
yaadetoon	یادتون	#exact
yad	یاد	#exact
yadam	یادم	#exact
yadame	یادمه	#exact
yade	یاد	#exact
yademon	یادمون	#exact
yadesh	یادش	#exact
yadeshon	یادشون	#exact
yadet	یادت	#exact
yaho	یاهو	yahoo	#exact
yalda	یلدا	#exact
yaldast	یلداست	#exact
yaldat	یلدات	#exact
yaldaye	یلدای	#exact
yaldayee	یلدایی	یلدای	#exact
yani	یعنی	#exact
yaran	یاران	#exact
yari	یاری	#exact
yaroo	یارو	#exact
yazdanijoo	یزدانیجو	#exact
yazdi	یزدی	#exact
ye	یه	#exact
yedoonei	یدونه‌ای	یه‌دونه‌ای	یه‌دونه‌یی	#exact
yegaane	یگان	یگانه	#exact
yeho	یهو	#exact
yejor	یه‌جور	یجور	#exact
yejurie	یجوریه	یجوری	#exact
yek	یک	#exact
yekam	یکم	#exact
yeki	یکی	#exact
yekja	یکجا	#exact
yeseri	یسری	یه‌سری	#exact
yevar	یه‌ور	#exact
yoho	یوهو	#exact
york	یورک	#exact
you	یو	تو	you	#exact
your	یور	#exact
zabane	زبان	#exact
zabtesho	ضبطشو	#exact
zad	زد	#exact
zadam	زدم	#exact
zadan	زدن	#exact
zadane	زدن	#exact
zade	زده	زاده	#exact
zadi	زدی	#exact
zadid	زدید	#exact
zadim	زدیم	زادیم	#exact
zadin	زدین	#exact
zaeef	ضعیف	#exact
zaghartie	زقارتیه	#exact
zahamate	زحمات	#exact
zaheran	ظاهرا	#exact
zahmat	زحمت	#exact
zahmatato	زحمتتو	#exact
zahmati	زحمتی	#exact
zahmaty	زحمتی	زحماتی	#exact
zahr	زهر	#exact
zahra	زهرا	#exact
zajr	زجر	#exact
zaman	زمان	#exact
zamanesham	زمانشم	#exact
zamani	زمانی	#exact
zamin	زمین	#exact
zamine	زمینه	#exact
zamini	زمینی	#exact
zan	زن	زان	#exact
zanet	زنت	#exact
zang	زنگ	#exact
zangam	زنگم	#exact
zanjan	زنجان	#exact
zarar	ضرر	#exact
zarfiat	ظرفیت	#exact
zarfiate	ظرفیت	#exact
zarori	ضروری	#exact
zarre	ذره	#exact
zavaye	زوای	#exact
zed	زد	#exact
zehnam	ذهنم	#exact
zehnet	ذهنت	#exact
zemestoon	زمستون	#exact
zemn	ضمن	#exact
zemzeme	زمزمه	زمزم	#exact
zendegi	زندگی	#exact
zendegie	زندگی	#exact
zendegim	زندگیم	#exact
zendegishon	زندگیشون	#exact
zendegito	زندگیتو	#exact
zendegiye	زندگی	#exact
zendegiye	زندگی	#exact
zendeh	زنده	#exact
zerti	زرتی	#exact
zeshte	زشته	#exact
ziad	زیاد	#exact
ziade	زیاده	#exact
ziadi	زیادی	#exact
ziadio	زیادی‌و	زیادی	#exact
ziba	زیبا	#exact
zibast	زیباست	#exact
zibayee	زیبایی	#exact
zidane	زیدان	#exact
zii	زی	زیی	#exact
zir	زیر	#exact
zire	زیر	#exact
ziyaad	زیاد	#exact
ziyad	زیاد	#exact
zogh	ذوق	#exact
zogh	ذوق	#exact
zogham	ذوقم	#exact
zohre	زهره	ظهر	#exact
zood	زود	#exact
zyadi	زیادی	#exact
